image_name,c1,c2,c3,c4,c5,c_total,MOS,SD,MOS_zscore
50012842.jpg,0,0,31,58,20,109,3.89908256880734,0.679664325215851,78.8636363636364
4668901744.jpg,0,1,40,65,3,109,3.64220183486239,0.553154853742444,70.9152542372881
611264152.jpg,0,15,67,26,1,109,3.11926605504587,0.634279565687073,59.3289473684211
2988609766.jpg,0,21,79,8,0,108,2.87962962962963,0.506363110683967,49.9159292035398
8078731890.jpg,0,1,53,49,2,105,3.4952380952381,0.556842221884494,67.4419642857143
7583515.jpg,10,71,23,3,0,107,2.17757009345794,0.626657562173502,31.781512605042
3665983083.jpg,0,0,23,77,3,103,3.80582524271845,0.465648449975302,78.1486486486486
466432603.jpg,1,13,76,17,0,107,3.01869158878505,0.566040674770481,54.3355263157895
8703712845.jpg,0,8,98,21,0,127,3.10236220472441,0.468612366787531,59.8145161290323
8999325582.jpg,0,0,35,66,4,105,3.7047619047619,0.535720390685605,73.1327433628319
2140864586.jpg,0,5,58,41,1,105,3.36190476190476,0.590368358344854,62.5521739130435
4707334942.jpg,0,4,46,59,1,110,3.51818181818182,0.58626196013806,70.7693965517241
8248564902.jpg,0,1,39,65,2,107,3.63551401869159,0.538910910208028,74.0921052631579
8158011851.jpg,0,1,42,62,0,105,3.58095238095238,0.514799295860353,69.2239130434783
8539488665.jpg,0,1,59,40,1,101,3.40594059405941,0.53250761162226,63.607476635514
9328964042.jpg,0,12,73,21,0,106,3.08490566037736,0.55408310410386,57.4586956521739
8158072489.jpg,0,2,31,61,12,106,3.78301886792453,0.661955501038323,75.9612068965517
2764641436.jpg,0,0,49,55,0,104,3.52884615384615,0.50158449460463,70.2673267326733
9346802331.jpg,0,47,55,6,0,108,2.62037037037037,0.591490949877323,43.41875
3675002443.jpg,1,39,59,9,0,108,2.7037037037037,0.630372375623148,46.2710084033613
9002438378.jpg,0,3,55,67,1,126,3.52380952380952,0.561630280013971,71.884
4702733058.jpg,0,6,62,34,1,103,3.29126213592233,0.587968719342113,61.9288990825688
6146146023.jpg,0,0,12,91,2,105,3.9047619047619,0.35420033237968,80.7739130434783
4704686099.jpg,0,23,74,5,0,102,2.82352941176471,0.495759537405347,50.0285714285714
4242548000.jpg,1,5,54,37,0,97,3.30927835051546,0.618479734615924,64.7572815533981
8297923368.jpg,1,2,55,69,0,127,3.51181102362205,0.575507253581685,70.8976377952756
7743542184.jpg,0,0,20,80,6,106,3.86792452830189,0.479592519464145,77.0592105263158
9096574214.jpg,0,2,66,37,1,106,3.34905660377358,0.535278349133619,63.2563025210084
6141827403.jpg,0,2,31,79,2,114,3.71052631578947,0.527537008902245,73.9327731092437
8274829582.jpg,0,0,6,99,8,113,4.01769911504425,0.353106137548202,80.0448717948718
62339435.jpg,0,4,48,54,2,108,3.5,0.603726743906886,67.4159663865546
8287040167.jpg,5,34,54,10,1,104,2.69230769230769,0.751398993941031,45.0743243243243
2801033102.jpg,1,45,54,8,0,108,2.63888888888889,0.633316936990578,43.4978991596639
9166594378.jpg,0,5,56,45,0,106,3.37735849056604,0.576571644062338,65.2548076923077
10911046243.jpg,0,0,28,71,4,103,3.76699029126214,0.508821851314784,76.2339449541284
3794248989.jpg,0,5,58,47,1,111,3.3963963963964,0.592057725675758,67.0705128205128
7362254314.jpg,0,14,71,25,0,110,3.1,0.589666365005118,54.9
4532664267.jpg,5,37,60,9,0,111,2.65765765765766,0.694072245329174,43.7058823529412
5782928744.jpg,0,7,64,36,1,108,3.28703703703704,0.59673450828806,62.3402777777778
6251598886.jpg,1,18,73,15,0,107,2.95327102803738,0.588941768753835,53.3727678571429
469009898.jpg,0,6,65,28,0,99,3.22222222222222,0.545024911536171,62.6370192307692
8467804997.jpg,0,9,61,33,1,104,3.25,0.619269848798622,61.9782608695652
9500372295.jpg,1,37,67,2,0,107,2.65420560747664,0.53381510010521,44.3125
4620749659.jpg,0,4,76,63,3,146,3.44520547945205,0.587582093079511,69.1887755102041
9581038288.jpg,0,2,54,48,1,105,3.45714285714286,0.555195243352965,65.7364864864865
8365545870.jpg,0,3,43,77,1,124,3.61290322580645,0.551563592945256,74.1680327868852
3925412649.jpg,0,4,57,41,1,103,3.37864077669903,0.579325247371913,65.466814159292
6071930227.jpg,29,75,4,1,0,109,1.78899082568807,0.54557809121954,21.14375
5412162988.jpg,0,1,34,66,5,106,3.70754716981132,0.568489747481794,75.0402542372881
2065542928.jpg,0,10,55,33,4,102,3.30392156862745,0.700625119549713,60.6651785714286
4955674278.jpg,0,12,111,29,0,152,3.11184210526316,0.508853302547423,59.1299342105263
2604683646.jpg,0,5,65,30,1,101,3.26732673267327,0.563756846679681,58.3715596330275
7987564601.jpg,0,10,67,26,0,103,3.15533980582524,0.573213876407266,58.4553571428571
9341616816.jpg,0,0,37,79,3,119,3.71428571428571,0.506614839539513,75.25
10706770686.jpg,0,0,25,78,3,106,3.79245283018868,0.472419932890129,76.8519417475728
6067656779.jpg,0,0,37,68,4,109,3.69724770642202,0.535837647398623,73.781779661017
5138115166.jpg,3,14,48,34,2,101,3.17821782178218,0.804935271981051,58.3644859813084
8239827069.jpg,0,15,66,26,0,107,3.10280373831776,0.613289605621399,58.2
4504786016.jpg,1,40,60,8,0,109,2.68807339449541,0.619098025302731,45.3163716814159
121123359.jpg,0,0,5,59,36,100,4.31,0.563090318750649,88.24375
7072533905.jpg,0,0,34,65,3,102,3.69607843137255,0.522545477414006,73.2453271028037
8375633718.jpg,2,41,75,10,0,128,2.7265625,0.623867083436268,47.4226190476191
5243954323.jpg,1,43,99,10,0,153,2.77124183006536,0.567737105883197,49.4423076923077
4940371977.jpg,0,2,52,48,2,104,3.48076923076923,0.574215703707125,66.4797297297297
8273957786.jpg,0,40,58,7,0,105,2.68571428571429,0.593462553323967,44.7544642857143
3939622523.jpg,0,24,48,31,0,103,3.06796116504854,0.731130415693104,55.0337837837838
5036806312.jpg,0,47,56,0,0,103,2.54368932038835,0.500523236598486,39.5486725663717
4867659714.jpg,0,9,66,32,0,107,3.21495327102804,0.583225212708778,61.0630841121495
8419805674.jpg,0,1,16,79,11,107,3.93457943925234,0.536779847310727,81.325
10430335945.jpg,3,47,54,2,0,106,2.5188679245283,0.589287415935903,39.9741379310345
5032946224.jpg,3,51,51,4,0,109,2.51376146788991,0.61786188824524,40.9915254237288
2982904736.jpg,0,0,26,77,2,105,3.77142857142857,0.465277891677131,74.4469026548673
8297827964.jpg,0,6,64,32,1,103,3.27184466019417,0.58063816746346,62.2857142857143
3533949779.jpg,0,5,61,36,1,103,3.32038834951456,0.580965933883841,63.641592920354
7011343645.jpg,0,0,50,60,2,112,3.57142857142857,0.532109277442409,70.7125
154270569.jpg,0,2,33,66,0,101,3.63366336633663,0.523884954493403,70.4772727272727
8550575599.jpg,0,9,73,24,0,106,3.14150943396226,0.542282288907294,57.3621495327103
4643928912.jpg,1,16,71,15,0,103,2.97087378640777,0.585047520771615,53.275
10733259996.jpg,0,4,69,27,0,100,3.23,0.509604719068583,62.3197115384615
8623218161.jpg,0,0,19,86,2,107,3.8411214953271,0.415490905612625,77.9760869565217
5570837854.jpg,0,15,72,17,0,104,3.01923076923077,0.557051342926048,55.8296460176991
2502332369.jpg,0,3,60,43,0,106,3.37735849056604,0.542530757323038,66.4393203883495
9762410596.jpg,0,0,39,67,4,110,3.68181818181818,0.540672672802991,70.9152542372881
11490304024.jpg,0,28,56,22,1,107,2.96261682242991,0.712757515792089,54.6973684210526
7998388938.jpg,0,0,15,84,7,106,3.92452830188679,0.451412876317967,79.1239130434783
8015526971.jpg,0,0,32,56,19,107,3.8785046728972,0.682811617627173,76.7752100840336
5649238461.jpg,3,29,61,10,0,103,2.75728155339806,0.663709412812857,48.6584821428571
2501256504.jpg,1,34,61,8,0,104,2.73076923076923,0.611075277500422,47.0889423076923
5594109805.jpg,0,2,38,61,3,104,3.625,0.577700496864656,74.0389908256881
9115676276.jpg,0,2,44,54,1,101,3.53465346534653,0.557931114666382,70.6330275229358
5040119968.jpg,1,61,38,0,0,100,2.37,0.505624925865573,34.8325688073394
6303418704.jpg,7,79,20,1,0,107,2.14018691588785,0.522125520418677,29.2120535714286
7395359632.jpg,22,76,5,0,0,103,1.83495145631068,0.487029559408928,21.5857142857143
4337515200.jpg,0,3,62,35,4,104,3.38461538461538,0.612296208343076,64.3685344827586
5995040588.jpg,0,0,9,84,7,100,3.98,0.401512292728531,80.9556074766355
7597470314.jpg,0,14,78,12,0,104,2.98076923076923,0.502049570731066,52.9308035714286
9321343770.jpg,0,3,31,75,2,111,3.68468468468468,0.555664744934667,73.8378378378378
8288373596.jpg,0,0,15,80,7,102,3.92156862745098,0.460010213184165,83.6617647058823
9058001335.jpg,0,10,75,23,1,109,3.13761467889908,0.568752532078318,58.0870535714286
10178112894.jpg,2,49,51,4,0,106,2.5377358490566,0.604341882142988,40.2586206896552
8438721601.jpg,0,0,22,76,11,109,3.89908256880734,0.54339389792714,77.4021739130435
6080237953.jpg,0,7,71,25,0,103,3.1747572815534,0.531870256662233,59.506880733945
4570337647.jpg,1,22,70,9,0,102,2.85294117647059,0.569819475035116,48.6077981651376
8477555984.jpg,0,4,67,39,0,110,3.31818181818182,0.540672672802991,63.0223214285714
6225884368.jpg,50,46,6,0,0,102,1.56862745098039,0.605417848038965,14.4929906542056
8850392186.jpg,3,30,71,4,0,108,2.7037037037037,0.5842042156589,46.8761682242991
4804414192.jpg,0,4,60,41,0,105,3.35238095238095,0.554369919210997,64.421875
3542002438.jpg,0,31,72,8,0,111,2.79279279279279,0.557871231755422,47.0336134453782
2859973577.jpg,0,2,47,81,1,131,3.61832061068702,0.532887854664426,74.1417910447761
6965585396.jpg,0,24,65,13,0,102,2.8921568627451,0.595475727034352,51.6148648648649
5788614098.jpg,0,11,68,27,0,106,3.15094339622642,0.582154501341495,58.972972972973
3742811862.jpg,0,14,75,16,1,106,3.0377358490566,0.567778097195539,54.8075221238938
6908900076.jpg,0,0,16,79,9,104,3.93269230769231,0.488000140795043,80.3881578947368
11013892854.jpg,6,93,12,0,0,111,2.05405405405405,0.400859028447609,27.4978813559322
2129680216.jpg,0,2,12,78,8,100,3.92,0.525702992538217,79.5642201834862
2415943373.jpg,0,1,41,57,2,101,3.59405940594059,0.550966747123312,70.9285714285714
8225184235.jpg,3,48,50,3,0,104,2.50961538461538,0.607320908240659,40.3402777777778
6433692937.jpg,1,39,57,8,0,105,2.68571428571429,0.625027471923707,45.7742718446602
4984086049.jpg,23,62,17,0,0,102,1.94117647058824,0.626534226412754,24.9567307692308
3904942577.jpg,31,73,1,0,0,105,1.71428571428571,0.474631146549323,18.2173913043478
10792125886.jpg,0,2,60,66,1,129,3.51162790697674,0.546527090330494,71.2224409448819
8083559682.jpg,0,0,12,86,12,110,4.0,0.469237132203465,77.45
2145860500.jpg,0,6,60,37,1,104,3.31730769230769,0.595524131992075,62.7276785714286
8715401905.jpg,18,71,12,0,0,101,1.94059405940594,0.544459037544935,22.9508928571429
2096424103.jpg,0,18,72,13,1,104,2.97115384615385,0.582207562647962,54.8851351351351
9401940143.jpg,2,40,57,1,0,100,2.57,0.555141259664437,41.4642857142857
8891882667.jpg,0,0,30,69,3,102,3.73529411764706,0.505934496371339,76.7572115384615
10164654253.jpg,0,16,71,13,0,100,2.97,0.540388935878782,52.9220183486239
8207527983.jpg,0,3,68,28,0,99,3.25252525252525,0.501903201160737,59.7523364485981
4955052105.jpg,0,6,67,33,0,106,3.25471698113208,0.553109319337024,61.6195652173913
9307347958.jpg,12,72,18,0,0,102,2.05882352941176,0.541788921884279,28.7291666666667
6956670735.jpg,0,20,69,18,0,107,2.98130841121495,0.598446233634422,55.1824324324324
5306390584.jpg,0,5,68,28,2,103,3.2621359223301,0.576690440094974,61.6486486486486
290161904.jpg,0,4,43,58,2,107,3.54205607476635,0.603142303553142,68.925
6791461596.jpg,0,5,78,26,0,109,3.19266055045872,0.499575082782089,60.2058823529412
6879970399.jpg,0,38,64,1,0,103,2.64077669902913,0.502042278745347,44.9513274336283
1794888173.jpg,4,24,68,12,0,108,2.81481481481481,0.67183871212187,49.5911016949153
5135451445.jpg,0,13,83,13,0,109,3.0,0.490653381462658,52.8072033898305
3463376543.jpg,1,18,55,24,1,99,3.06060606060606,0.711683571886767,56.3055555555556
9497810800.jpg,0,3,73,31,1,108,3.27777777777778,0.526553479694317,61.0862831858407
3448332578.jpg,0,12,77,16,0,105,3.03809523809524,0.517460692000434,54.5154867256637
4688942670.jpg,0,6,56,41,3,106,3.38679245283019,0.640992604028072,65.2065217391304
5935910099.jpg,0,3,57,37,2,99,3.38383838383838,0.583918339046576,65.125
9934338535.jpg,0,2,32,66,2,102,3.66666666666667,0.551026644579283,72.9369158878505
3601117533.jpg,0,2,60,47,1,110,3.42727272727273,0.549546784229254,65.625
8443583255.jpg,0,2,32,71,8,113,3.75221238938053,0.605495273240478,72.8108695652174
7731352704.jpg,0,0,16,88,6,110,3.90909090909091,0.439880186886929,76.00625
7590781464.jpg,0,3,23,71,4,101,3.75247524752475,0.572816560411087,74.644495412844
3423896683.jpg,0,1,44,60,0,105,3.56190476190476,0.517460692000434,68.7837837837838
7002011797.jpg,0,3,48,47,1,99,3.46464646464646,0.576993108456905,70.2839805825243
6332564856.jpg,0,7,71,31,0,109,3.22018348623853,0.55038367367073,61.328125
9710823281.jpg,2,10,43,40,2,97,3.30927835051546,0.768668013816054,65.2714285714286
8505294712.jpg,0,0,51,54,2,107,3.54205607476635,0.536944075507108,70.2282608695652
2818844013.jpg,0,1,43,61,0,105,3.57142857142857,0.516220414632661,71.0471698113208
4172951303.jpg,0,13,72,20,0,105,3.06666666666667,0.559303596287842,56.1216814159292
7704019566.jpg,0,1,31,62,5,99,3.71717171717172,0.572149617231404,72.037610619469
10110458216.jpg,0,4,56,39,1,100,3.37,0.580055727033745,64.7293577981651
6072373526.jpg,0,0,50,54,0,104,3.51923076923077,0.502049570731066,69.8528037383178
640351831.jpg,0,1,45,60,3,109,3.59633027522936,0.563048350911192,69.6776315789474
4711939216.jpg,3,88,18,3,0,112,2.1875,0.511687721490681,31.5454545454545
4297599043.jpg,0,6,102,46,1,155,3.27096774193548,0.538271372433303,63.7
3547073718.jpg,0,0,21,83,5,109,3.85321100917431,0.467968186505642,77.2942477876106
8120535413.jpg,2,36,61,8,0,107,2.70093457943925,0.632678541748658,46.825
4580698398.jpg,5,64,36,1,0,106,2.31132075471698,0.575089352016914,34.0711206896552
2459857216.jpg,0,0,46,92,1,139,3.67625899280576,0.484780352745111,75.25
6024552297.jpg,28,65,17,1,0,111,1.91891891891892,0.662435384638108,23.775641025641
7365681654.jpg,2,80,23,2,0,107,2.23364485981308,0.506177671326723,32.8521739130435
4239274380.jpg,20,88,28,1,0,137,2.07299270072993,0.61399171886002,27.5017123287671
6986935908.jpg,0,0,48,53,2,103,3.55339805825243,0.537389392902424,68.8415178571429
6679373485.jpg,1,47,60,2,0,110,2.57272727272727,0.549546784229254,42.6625
3886880606.jpg,0,1,29,68,2,100,3.71,0.518252697615612,75.7798165137615
3711573590.jpg,0,5,68,28,4,105,3.2952380952381,0.618991262579839,61.5948275862069
4972615412.jpg,6,59,40,3,0,108,2.37037037037037,0.635295098000753,36.4308035714286
9269067450.jpg,2,47,43,9,0,101,2.58415841584158,0.682163129063324,43.4174528301887
93917546.jpg,1,27,53,22,0,103,2.93203883495146,0.717595876252306,51.3319327731092
3754491822.jpg,3,60,42,3,0,108,2.41666666666667,0.597893498471106,38.2723214285714
5407049859.jpg,0,1,38,57,7,103,3.67961165048544,0.613789135296507,72.6486486486486
4345036113.jpg,0,1,25,73,4,103,3.77669902912621,0.522663593583743,76.7101769911504
8460154333.jpg,1,41,48,12,0,102,2.69607843137255,0.686348000613413,44.6720183486239
8488394767.jpg,0,1,54,49,1,105,3.47619047619048,0.538788493096354,69.2647058823529
3629779382.jpg,0,0,55,47,2,104,3.49038461538462,0.539600576976746,70.8823529411765
8303662528.jpg,0,5,56,43,1,105,3.38095238095238,0.594541717190521,65.6004464285714
7756416864.jpg,8,61,36,2,0,107,2.29906542056075,0.632678541748658,37.0200892857143
9071963923.jpg,0,0,18,82,5,105,3.87619047619048,0.453516984993567,77.1869565217391
1797683075.jpg,8,63,32,4,0,107,2.29906542056075,0.661829272732638,34.8897058823529
6066179576.jpg,0,19,76,14,0,109,2.95412844036697,0.550846505152943,54.1907894736842
5540094499.jpg,0,3,44,54,1,102,3.51960784313725,0.575582221924289,72.2146226415094
3332902834.jpg,0,10,53,48,1,112,3.35714285714286,0.655635897322919,63.8974358974359
5891304676.jpg,1,20,81,13,0,115,2.92173913043478,0.564254298881501,53.2266949152542
7810074740.jpg,0,1,26,62,12,101,3.84158415841584,0.628214505838997,75.3217391304348
8377341554.jpg,0,2,29,64,8,103,3.75728155339806,0.617807943656135,77.6283783783784
4443705808.jpg,5,65,26,6,0,102,2.32352941176471,0.662455150073616,34.6513157894737
3366831652.jpg,0,7,55,46,2,110,3.39090909090909,0.636726930732686,62.2857142857143
8059797614.jpg,0,6,64,34,0,104,3.26923076923077,0.561391634768236,60.6775700934579
4605356871.jpg,0,3,62,44,2,111,3.40540540540541,0.578059109566084,65.7588495575221
6469390735.jpg,5,54,48,0,0,107,2.4018691588785,0.58049772209769,39.1737288135593
3779311128.jpg,0,9,76,22,0,107,3.1214953271028,0.526832478007591,59.4639423076923
4199130600.jpg,0,4,28,65,5,102,3.69607843137255,0.625991738886346,71.3421052631579
3903483278.jpg,6,40,56,6,0,108,2.57407407407407,0.686365256616176,42.25
4309440479.jpg,0,16,105,33,0,154,3.11038961038961,0.554973806267453,58.75
6238203210.jpg,2,36,49,19,1,107,2.82242990654206,0.774756006779268,47.40625
9895678845.jpg,0,3,81,16,1,101,3.14851485148515,0.455766137703568,57.7476635514019
9029384629.jpg,14,111,31,0,0,156,2.10897435897436,0.527608334067048,30.2641509433962
3412359483.jpg,0,1,47,60,3,111,3.58558558558559,0.563567669058932,67.9545454545455
6224309834.jpg,28,82,21,1,0,132,1.96212121212121,0.63492865536941,23.3055555555556
5629171325.jpg,1,12,42,51,2,108,3.37962962962963,0.745297940707132,62.325
3365447434.jpg,25,95,13,0,0,133,1.90977443609023,0.528844460958976,22.4375
6749380301.jpg,0,2,50,51,1,104,3.49038461538462,0.557302663192804,69.0067567567568
5799422140.jpg,1,33,67,4,0,105,2.7047619047619,0.553377905438143,44.777027027027
8486846186.jpg,0,1,31,68,1,101,3.68316831683168,0.508540914171258,75.5555555555556
4752962359.jpg,0,5,78,22,0,105,3.16190476190476,0.482856275873249,57.3378378378378
8375094776.jpg,0,1,40,60,3,104,3.625,0.560642834922123,69.2297297297297
9029712750.jpg,0,1,37,62,4,104,3.66346153846154,0.567922067043096,71.2326086956522
5664036497.jpg,0,1,32,64,7,104,3.74038461538462,0.591118608959406,73.6
6056249968.jpg,0,32,65,11,1,109,2.8256880733945,0.636018237236307,48.64375
4985988258.jpg,0,18,62,27,0,107,3.08411214953271,0.646054722361008,55.6995798319328
5221875216.jpg,0,39,63,7,0,109,2.70642201834862,0.582185414870968,47.9830508474576
4113272660.jpg,1,15,53,34,2,105,3.2,0.739022223044643,60.3705357142857
6345505389.jpg,0,1,56,62,1,120,3.525,0.533932611490856,70.146186440678
3355200103.jpg,0,1,51,82,4,138,3.64492753623188,0.55105373031019,75.3645833333333
6309436752.jpg,0,26,60,16,1,103,2.92233009708738,0.666999726435983,50.2729357798165
6486906969.jpg,5,54,44,4,0,107,2.4392523364486,0.646873031393711,38.2385321100917
7954849148.jpg,0,1,18,80,4,103,3.84466019417476,0.480140534030996,79.1822429906542
7055266351.jpg,0,0,30,71,6,107,3.77570093457944,0.537436458990222,74.15
3537245055.jpg,0,15,86,32,0,133,3.12781954887218,0.582751231224555,59.0
6028637115.jpg,5,48,45,4,0,102,2.47058823529412,0.655606171823823,40.4428571428571
6993655335.jpg,0,0,17,72,15,104,3.98076923076923,0.557051342926048,79.3378378378378
5884906716.jpg,0,2,32,74,1,109,3.67889908256881,0.524946804094263,71.1949152542373
9495726171.jpg,0,0,30,71,5,106,3.76415094339623,0.526477726068939,75.3199152542373
7337709978.jpg,0,2,65,39,0,106,3.34905660377358,0.517180134966139,63.7139830508475
3118054377.jpg,0,5,63,37,1,106,3.32075471698113,0.578127845662116,63.7160194174757
3566227002.jpg,1,4,46,43,3,97,3.44329896907217,0.676527163857022,68.8422330097087
9530920367.jpg,0,3,43,54,1,101,3.52475247524752,0.576091301894771,67.9930555555556
5251074570.jpg,1,23,51,31,1,107,3.07476635514019,0.761093237779179,53.31875
8268859988.jpg,2,44,56,2,0,104,2.55769230769231,0.571608581483598,41.604347826087
153876946.jpg,0,15,70,19,0,104,3.03846153846154,0.573239422405291,52.9264705882353
526020496.jpg,0,13,82,12,0,107,2.99065420560748,0.4855521483138,54.925
9772275331.jpg,0,2,32,73,4,111,3.71171171171171,0.562258229049888,74.9679487179487
253771260.jpg,4,58,29,8,0,99,2.41414141414141,0.700001472448903,37.7125
6903462833.jpg,1,8,60,37,0,106,3.25471698113208,0.633378255370013,62.125
8116711629.jpg,1,0,19,76,6,102,3.84313725490196,0.55837632434446,77.1357142857143
8539498079.jpg,1,11,63,27,0,102,3.13725490196078,0.62993345061479,57.775
6316913705.jpg,0,21,81,6,0,108,2.86111111111111,0.482561958315932,50.010593220339
7738480598.jpg,5,75,23,2,0,105,2.20952380952381,0.549391938265845,31.3947368421053
6555285779.jpg,0,28,76,8,0,112,2.82142857142857,0.540508364550718,48.0320512820513
9527961628.jpg,1,18,99,22,0,140,3.01428571428571,0.562442186134798,56.3367346938776
2899446484.jpg,8,58,41,3,0,110,2.35454545454545,0.657858126368209,35.71875
904761358.jpg,2,25,67,7,0,101,2.78217821782178,0.593362627674504,46.7155963302752
45015821.jpg,26,69,10,2,0,107,1.88785046728972,0.63434861559577,23.9322033898305
2350031609.jpg,2,52,44,3,0,101,2.47524752475248,0.593195741824578,40.0
7466614786.jpg,0,0,32,70,5,107,3.74766355140187,0.533649908982546,77.2
8308350290.jpg,0,0,61,43,0,104,3.41346153846154,0.494838934727131,63.5565217391304
8452514438.jpg,4,48,53,1,0,106,2.4811320754717,0.589287415935903,40.7767857142857
4486733557.jpg,0,8,69,24,0,101,3.15841584158416,0.542819919813684,58.975
5594639206.jpg,0,7,61,34,0,102,3.26470588235294,0.578945278424999,60.475
5300293470.jpg,0,14,71,18,0,103,3.03883495145631,0.558750884494407,57.0848623853211
8466537488.jpg,0,1,33,66,1,101,3.66336633663366,0.515310153650639,74.5199115044248
9055879747.jpg,0,14,71,12,0,97,2.97938144329897,0.520003634668767,54.2844036697248
4223697086.jpg,0,6,54,45,0,105,3.37142857142857,0.592535991395376,64.472972972973
1331642031.jpg,0,19,107,14,0,140,2.96428571428571,0.48592734581001,54.2905405405405
6961812492.jpg,0,5,62,38,0,105,3.31428571428571,0.560121650836909,63.5263157894737
4195632386.jpg,10,80,20,0,0,110,2.09090909090909,0.516613079807823,29.4871794871795
8323120996.jpg,0,2,53,49,1,105,3.46666666666667,0.55585462035892,67.3618421052632
6268918476.jpg,0,3,43,58,2,106,3.55660377358491,0.586842863355548,71.4196428571429
4885928195.jpg,0,13,83,9,0,105,2.96190476190476,0.458337495818594,52.2217391304348
5495551820.jpg,0,34,64,6,0,104,2.73076923076923,0.561391634768236,46.9847826086957
6199129652.jpg,0,9,56,37,1,103,3.29126213592233,0.63602731414348,64.3028846153846
9476849940.jpg,0,2,40,61,1,104,3.58653846153846,0.550561530172921,73.4705882352941
4989495161.jpg,0,0,23,78,8,109,3.86238532110092,0.517613646641916,77.2942477876106
3628043.jpg,1,5,42,45,16,109,3.64220183486239,0.822405412548577,70.75
8258234240.jpg,0,1,39,69,3,112,3.66071428571429,0.546134185216919,73.0641025641026
392103652.jpg,8,65,36,2,0,111,2.28828828828829,0.623587675360561,33.3707627118644
5951267818.jpg,1,2,42,60,1,106,3.54716981132075,0.603672498276344,69.656779661017
6186608340.jpg,1,51,54,8,0,114,2.60526315789474,0.632713233882272,43.2205882352941
6000772290.jpg,0,0,19,78,8,105,3.8952380952381,0.498532645405292,78.1486486486486
8164370728.jpg,1,13,68,22,0,104,3.06730769230769,0.611609734645443,58.2647058823529
9594906572.jpg,0,1,18,80,5,104,3.85576923076923,0.491051363274922,77.0280172413793
6238988012.jpg,0,24,68,13,0,105,2.8952380952381,0.587101903155359,52.4913793103448
3329470769.jpg,0,19,71,21,0,111,3.01801801801802,0.602750996107649,55.5875
8644731627.jpg,0,4,64,37,0,105,3.31428571428571,0.542683604419273,61.5743243243243
6117273943.jpg,0,0,29,71,3,103,3.74757281553398,0.499380922663678,72.671875
5617865491.jpg,0,18,70,15,0,103,2.97087378640777,0.56804291952612,53.9110576923077
5590319772.jpg,1,50,45,5,0,101,2.53465346534653,0.609333347776791,40.2638888888889
4540896523.jpg,2,53,47,2,0,104,2.47115384615385,0.573809121695014,38.9934210526316
5906327236.jpg,0,1,51,60,0,112,3.52678571428571,0.5191785165493,66.6474358974359
3330470420.jpg,0,11,77,14,0,102,3.02941176470588,0.496639845060589,54.6628440366973
9038497618.jpg,0,4,55,40,1,100,3.38,0.582228390745332,64.4556074766355
7510743692.jpg,0,7,56,42,1,106,3.34905660377358,0.617868113993033,65.6004464285714
4883647933.jpg,0,9,72,25,0,106,3.15094339622642,0.548460231317574,59.5889830508475
8565941333.jpg,0,2,35,64,2,103,3.64077669902913,0.557557153177668,73.0401785714286
3048643650.jpg,0,18,101,10,0,129,2.93798449612403,0.463545069014602,53.2283464566929
8602273631.jpg,0,13,60,33,1,107,3.20560747663551,0.654999895679228,62.1470588235294
7141864663.jpg,0,13,70,18,0,101,3.04950495049505,0.554549143426665,53.7702702702703
2410933503.jpg,0,0,31,72,6,109,3.77064220183486,0.538052515730571,73.66875
9139430214.jpg,2,12,74,14,0,102,2.98039215686275,0.5798666995481,52.2408256880734
2838590977.jpg,0,21,80,4,0,105,2.83809523809524,0.462514231045288,47.9891304347826
4217551619.jpg,0,8,48,40,7,103,3.44660194174757,0.737352914409613,64.1272321428571
2415334988.jpg,3,50,48,2,0,103,2.47572815533981,0.591519482286928,38.4094827586207
10864812016.jpg,0,12,77,17,0,106,3.04716981132075,0.52339688067375,56.8847826086957
8452429942.jpg,16,71,16,0,0,103,2.0,0.560112033611204,25.6736111111111
6954316003.jpg,0,5,69,29,4,107,3.29906542056075,0.617587412971562,59.7899159663866
4637538714.jpg,24,74,9,0,0,107,1.85981308411215,0.539891640610202,23.89375
5748620149.jpg,0,10,81,15,0,106,3.04716981132075,0.485642931178632,56.9821428571429
2766412345.jpg,6,58,41,1,0,106,2.34905660377358,0.602256911327458,37.1216216216216
6905163828.jpg,0,1,44,61,1,107,3.57943925233645,0.532657686415534,72.5982142857143
6526093429.jpg,5,35,62,9,0,111,2.67567567567568,0.689692450064285,46.6217948717949
3341085556.jpg,25,68,7,0,0,100,1.82,0.538985204347068,20.6032110091743
3112707699.jpg,10,81,38,0,0,129,2.21705426356589,0.572293089111656,31.6428571428571
8545905705.jpg,8,82,18,2,0,110,2.12727272727273,0.543672373500889,29.875
3243501762.jpg,3,55,45,2,0,105,2.43809523809524,0.587101903155359,37.3445945945946
5209944633.jpg,5,62,33,5,0,105,2.36190476190476,0.652271320431824,36.9671052631579
8121591181.jpg,0,15,63,23,0,101,3.07920792079208,0.611280104646498,57.2571428571429
5489335291.jpg,0,0,31,69,9,109,3.79816513761468,0.573808209566535,76.4911504424779
8493065081.jpg,0,1,30,63,8,102,3.76470588235294,0.599941756054806,75.6428571428571
8751989930.jpg,14,88,7,0,0,109,1.93577981651376,0.436213279422361,25.260593220339
4259335567.jpg,1,50,48,2,0,101,2.5049504950495,0.558994854649622,39.9459459459459
452671189.jpg,32,59,15,1,0,107,1.85981308411215,0.679186501894357,23.4665178571429
8681619509.jpg,0,11,73,23,0,107,3.11214953271028,0.555030218516758,57.0405405405405
9216910965.jpg,0,6,57,40,0,103,3.33009708737864,0.583907552355093,64.8638392857143
8501698385.jpg,0,2,50,56,2,110,3.52727272727273,0.570032848065116,69.0810810810811
6350910177.jpg,0,1,34,71,1,107,3.67289719626168,0.50982240590043,71.5063025210084
4895451556.jpg,0,0,26,77,8,111,3.83783783783784,0.531559293546151,76.1588983050847
2837843986.jpg,9,78,39,0,0,126,2.23809523809524,0.571714214321406,33.6673387096774
5055213857.jpg,0,31,74,6,0,111,2.77477477477477,0.534018806013501,48.8194444444444
6784185258.jpg,55,40,3,0,0,98,1.46938775510204,0.559898400810326,11.0833333333333
7867041724.jpg,0,0,36,68,4,108,3.7037037037037,0.534059733773752,73.7302631578947
5361947887.jpg,0,2,66,34,2,104,3.34615384615385,0.553352198616052,62.9121621621622
5903878980.jpg,0,6,47,43,3,99,3.43434343434343,0.657167952340955,67.6939252336449
299211567.jpg,7,71,23,1,0,102,2.17647058823529,0.552434122337155,30.55
2569997123.jpg,0,1,45,55,0,101,3.53465346534653,0.520852309885318,71.9197247706422
5479353117.jpg,0,17,67,18,0,102,3.00980392156863,0.588589487618462,53.6319444444444
8358374077.jpg,0,2,50,49,1,102,3.48039215686275,0.55811550238036,67.0
6179066994.jpg,0,4,71,28,1,104,3.25,0.535170783012574,62.3830275229358
5276579774.jpg,0,10,81,13,0,104,3.02884615384615,0.471657493988539,54.198275862069
1312413141.jpg,37,57,9,1,0,104,1.75,0.649869292309906,19.4151785714286
9090441923.jpg,0,1,42,52,1,96,3.55208333333333,0.540366185132904,72.2642857142857
1348094685.jpg,0,1,31,71,5,108,3.74074074074074,0.553162029808515,72.3834745762712
9005619499.jpg,0,4,38,58,7,107,3.63551401869159,0.664355601592746,70.1890756302521
3405525198.jpg,7,65,39,1,0,112,2.30357142857143,0.597883439697578,34.2115384615385
7870300862.jpg,1,29,68,8,0,106,2.78301886792453,0.585616760447309,48.5423728813559
7530958636.jpg,0,7,60,35,6,108,3.37037037037037,0.691640236455322,63.5336134453782
8736395579.jpg,0,1,50,52,2,105,3.52380952380952,0.556348640264187,69.3349056603774
5842931891.jpg,0,0,45,55,1,101,3.56435643564356,0.517993080729046,69.9027777777778
323541643.jpg,30,75,15,1,0,121,1.89256198347107,0.629836657297774,23.55
8358381896.jpg,0,5,75,21,0,101,3.15841584158416,0.484410430674789,57.85
8350532456.jpg,0,3,44,60,3,110,3.57272727272727,0.597534550981236,66.8613445378151
5531274580.jpg,0,2,43,56,0,101,3.53465346534653,0.539710226615053,66.4701834862385
4151551954.jpg,0,4,69,22,0,95,3.18947368421053,0.490217859560448,59.3
6946044735.jpg,0,49,54,7,0,110,2.61818181818182,0.605507114509346,43.4285714285714
3989767571.jpg,0,15,100,10,0,125,2.96,0.447213595499958,55.0609756097561
220183616.jpg,1,42,52,4,0,99,2.5959595959596,0.587613504783473,41.5567226890756
325296963.jpg,3,36,53,7,0,99,2.64646464646465,0.659516386099157,44.5416666666667
10178914656.jpg,0,0,53,52,1,106,3.50943396226415,0.520901837363733,69.7991071428571
6379443681.jpg,0,26,76,6,1,109,2.8348623853211,0.553001263609331,47.921875
5097621606.jpg,0,4,61,34,1,100,3.32,0.566399223876658,62.2316513761468
5788815207.jpg,0,2,47,48,1,98,3.48979591836735,0.56064943857357,67.0
8087906672.jpg,0,0,37,66,3,106,3.67924528301887,0.526392390510218,73.1138392857143
10069534975.jpg,0,1,34,72,1,108,3.67592592592593,0.508409719674872,73.7222222222222
8081563599.jpg,6,60,34,1,0,101,2.2970297029703,0.592360607323707,35.8857142857143
10047832035.jpg,0,0,38,60,3,101,3.65346534653465,0.537320082713394,71.8
4806110659.jpg,0,3,68,27,2,100,3.28,0.55194788218315,63.9158878504673
6274950285.jpg,0,1,21,73,4,99,3.80808080808081,0.508634981518014,76.675
9298572085.jpg,0,0,28,80,3,111,3.77477477477477,0.480240180150131,73.275641025641
6846284796.jpg,1,1,60,39,1,102,3.37254901960784,0.578861440139363,63.6116071428571
3683418770.jpg,0,14,66,25,1,106,3.12264150943396,0.627964666714226,55.9533898305085
5919706356.jpg,1,23,64,11,0,99,2.85858585858586,0.606261562231019,47.287610619469
2743703757.jpg,0,17,78,6,0,101,2.89108910891089,0.466925906306555,52.75
2492228578.jpg,11,65,28,3,0,107,2.21495327102804,0.659159518918379,31.1756756756757
5434458853.jpg,0,9,46,47,3,105,3.41904761904762,0.69033091815214,67.0
3471704982.jpg,0,5,48,55,1,109,3.47706422018349,0.602407673504281,65.55625
898061275.jpg,0,2,43,86,4,135,3.68148148148148,0.555190593223407,75.4347014925373
2532088252.jpg,0,0,42,71,1,114,3.64035087719298,0.500038812342383,70.945652173913
7753523026.jpg,0,6,73,21,1,101,3.16831683168317,0.530458423077494,58.3715596330275
7358753494.jpg,1,21,66,14,0,102,2.91176470588235,0.615041513152086,54.1504424778761
10856434794.jpg,1,45,63,4,0,113,2.61946902654867,0.571941931224485,44.0375
3574423584.jpg,0,7,71,31,0,109,3.22018348623853,0.55038367367073,61.8163716814159
6177131907.jpg,0,9,74,22,0,105,3.12380952380952,0.531602043450486,57.3152173913044
6649624069.jpg,0,3,64,37,2,106,3.35849056603774,0.572191763481324,64.345652173913
5480778835.jpg,0,20,57,28,3,108,3.12962962962963,0.737418997200124,56.4621848739496
8650038281.jpg,0,5,58,38,0,101,3.32673267326733,0.567607450463595,63.475
6458056243.jpg,2,39,63,2,0,106,2.61320754716981,0.561812622838427,42.6880530973451
4805501528.jpg,1,3,60,46,1,111,3.38738738738739,0.605597693810476,64.9724576271186
11062902804.jpg,0,3,39,61,4,107,3.61682242990654,0.608816665608245,69.9117647058823
5616548747.jpg,0,3,20,77,2,102,3.76470588235294,0.529832228036428,75.475
7334314036.jpg,0,0,20,89,1,110,3.82727272727273,0.40317753753441,75.25
4522459343.jpg,0,0,34,69,4,107,3.7196261682243,0.528336523035191,75.25
5761873238.jpg,2,40,58,6,0,106,2.64150943396226,0.620117949537605,42.5446428571429
7061755895.jpg,0,0,17,77,8,102,3.91176470588235,0.489553063022048,79.5306603773585
223191871.jpg,7,43,45,8,0,103,2.52427184466019,0.738900351398985,40.7247899159664
8498158756.jpg,0,0,13,83,9,105,3.96190476190476,0.458337495818594,83.3366336633663
5028571969.jpg,0,6,68,30,0,104,3.23076923076923,0.543822665820023,60.0301724137931
5802112389.jpg,0,2,52,52,1,107,3.48598130841122,0.555665264741086,69.75
3455219027.jpg,4,71,27,0,0,102,2.22549019607843,0.505550630992575,30.7
3932630945.jpg,0,4,58,41,0,103,3.35922330097087,0.557557153177668,61.6227678571429
4906735319.jpg,0,0,25,68,6,99,3.80808080808081,0.528315916558584,78.4583333333333
8596148572.jpg,0,7,61,32,0,100,3.25,0.575159178669767,61.75
9291621754.jpg,0,2,63,32,0,97,3.30927835051546,0.507461508028525,65.1577669902913
2217543976.jpg,0,1,31,73,1,106,3.69811320754717,0.500852821661969,76.1339285714286
3600948934.jpg,1,41,60,2,0,104,2.60576923076923,0.547159819941693,42.6183035714286
4157144630.jpg,0,27,77,8,0,112,2.83035714285714,0.535048921854206,50.2203389830508
5314923965.jpg,3,26,57,18,0,104,2.86538461538462,0.724839350231836,49.7289719626168
5224064761.jpg,0,8,33,60,2,103,3.54368932038835,0.668282830654486,71.6802884615385
4943600012.jpg,0,6,48,45,4,103,3.45631067961165,0.668282830654486,69.3798076923077
7880797072.jpg,0,17,85,7,0,109,2.90825688073395,0.462306704425587,53.1985981308411
4670590256.jpg,0,4,77,27,0,108,3.21296296296296,0.49390539647944,59.1959459459459
5625316207.jpg,0,2,87,39,1,129,3.30232558139535,0.509360063627494,64.357421875
3971050023.jpg,0,3,21,67,16,107,3.89719626168224,0.672008808332494,77.51875
8664375707.jpg,0,7,55,44,1,107,3.36448598130841,0.620293955945691,65.9205607476636
5213032846.jpg,17,83,13,0,0,113,1.9646017699115,0.516326369996713,25.2478260869565
11023346856.jpg,0,2,73,28,1,104,3.26923076923077,0.506861066174239,62.1513157894737
10990887046.jpg,1,18,98,28,1,146,3.06849315068493,0.606374576923349,58.0765306122449
2753606061.jpg,0,10,80,37,0,127,3.21259842519685,0.572240393205992,62.2096774193548
2908654044.jpg,2,53,48,3,0,106,2.49056603773585,0.589516073028878,41.5870535714286
3121612010.jpg,0,10,83,14,0,107,3.03738317757009,0.474346295857342,57.2767857142857
9142684025.jpg,0,0,36,71,1,108,3.67592592592593,0.489682401434681,73.5861344537815
8175828572.jpg,0,1,38,68,2,109,3.65137614678899,0.533613585898434,70.7754237288136
4596719098.jpg,0,18,72,18,0,108,3.0,0.580041893427398,54.8851351351351
8522546794.jpg,11,71,22,0,0,104,2.10576923076923,0.555960975629318,28.8632075471698
4468449550.jpg,2,13,62,29,0,106,3.11320754716981,0.680626528133925,58.5290178571429
5920736883.jpg,1,12,96,27,0,136,3.09558823529412,0.556159802116439,58.2852112676056
9707913077.jpg,0,0,23,67,11,101,3.88118811881188,0.570738621662689,78.5347222222222
5723599109.jpg,0,16,81,12,0,109,2.96330275229358,0.507838657387166,55.0265486725664
4590098379.jpg,0,13,70,17,0,100,3.04,0.549011968370582,55.588785046729
6245749984.jpg,1,16,70,18,1,106,3.0188679245283,0.632171346203991,54.2631578947368
2147067327.jpg,0,1,53,50,0,104,3.47115384615385,0.520580907214179,67.1486486486486
5543308408.jpg,0,0,21,81,4,106,3.83962264150943,0.460575053659996,76.7625
6332554758.jpg,0,1,36,65,0,102,3.62745098039216,0.505838557336368,74.2569444444444
4828896285.jpg,0,2,45,64,11,122,3.68852459016393,0.656587310328597,75.8
8988404310.jpg,4,31,65,7,0,107,2.70093457943925,0.647417996133495,44.7172897196262
8129206186.jpg,0,4,49,75,4,132,3.59848484848485,0.603549911732149,72.875
4374031327.jpg,0,3,66,34,0,103,3.30097087378641,0.520839282280893,62.9142857142857
6467546565.jpg,5,83,19,0,0,107,2.13084112149533,0.457311919263665,29.7710084033613
3652633823.jpg,0,0,61,73,0,134,3.54477611940298,0.499859704253811,71.8321428571429
8474312023.jpg,0,2,48,57,2,109,3.54128440366972,0.569797073880386,68.5921052631579
4037555676.jpg,21,73,15,0,0,109,1.94495412844037,0.574695771132691,24.1419491525424
8086705362.jpg,0,0,35,65,5,105,3.71428571428571,0.549725206078275,74.0021008403361
2742066850.jpg,14,75,14,2,0,105,2.03809523809524,0.587101903155359,27.5022123893805
7402614702.jpg,21,66,13,1,0,101,1.94059405940594,0.613543513994204,23.725
5756854423.jpg,6,32,62,6,0,106,2.64150943396226,0.678775918495346,42.6216216216216
5191833722.jpg,11,60,30,4,0,105,2.25714285714286,0.693771346567932,33.5373831775701
8540532034.jpg,0,22,66,14,0,102,2.92156862745098,0.591796635357012,52.6949541284404
2201178081.jpg,1,12,69,16,0,98,3.02040816326531,0.574000104830169,55.1357142857143
751468322.jpg,12,82,17,0,0,111,2.04504504504505,0.511457585327329,28.9935897435897
2709928858.jpg,0,24,61,18,0,103,2.94174757281553,0.639013374287707,51.025
3879362113.jpg,0,1,34,65,6,106,3.71698113207547,0.581536830609117,74.4608695652174
2584408449.jpg,0,0,26,75,4,105,3.79047619047619,0.494104436469856,76.35
1966235400.jpg,0,1,51,53,0,105,3.4952380952381,0.521163814564789,68.7094594594595
3722409963.jpg,9,67,35,2,0,113,2.26548672566372,0.627035245008551,34.1386554621849
9183486925.jpg,14,71,23,0,0,108,2.08333333333333,0.582052443280648,27.5592105263158
6972495879.jpg,0,0,16,75,11,102,3.95098039215686,0.514684388158128,78.8073394495413
4598385226.jpg,1,18,71,17,0,107,2.97196261682243,0.605913374548902,54.7806603773585
4965802871.jpg,8,44,55,2,0,109,2.46788990825688,0.660650736149587,37.9040178571429
4851066149.jpg,6,69,36,1,0,112,2.28571428571429,0.576234615453057,34.6875
7005136305.jpg,0,0,29,84,1,114,3.75438596491228,0.452356729556137,78.7544247787611
6318820907.jpg,0,8,65,29,0,102,3.20588235294118,0.568796458994521,61.8819444444444
8617343673.jpg,0,0,28,76,3,107,3.76635514018692,0.487183651636056,76.4285714285714
8178834291.jpg,0,21,75,6,0,102,2.85294117647059,0.495465753949974,51.3561320754717
3616806128.jpg,0,2,56,43,0,101,3.40594059405941,0.53250761162226,63.3669724770642
9653610008.jpg,0,1,42,57,3,103,3.60194174757282,0.566028576588288,73.4254807692308
2696730288.jpg,1,4,44,49,3,101,3.48514851485149,0.672515596639046,67.8175675675676
7071306923.jpg,0,9,69,29,0,107,3.18691588785047,0.568527411288765,58.8898305084746
11519797605.jpg,0,1,29,71,6,107,3.76635514018692,0.559302787883853,72.9125
9528230846.jpg,0,2,32,61,3,98,3.66326530612245,0.573358302739228,73.0550458715596
3376669178.jpg,0,19,73,11,0,103,2.92233009708738,0.536680435611023,50.5771028037383
3125804438.jpg,0,12,74,22,0,108,3.09259259259259,0.555970769033215,56.4125
9109271301.jpg,0,1,42,60,2,105,3.6,0.547722557505166,71.7803738317757
8267105534.jpg,0,0,24,74,12,110,3.89090909090909,0.564149998686089,78.61875
4600229706.jpg,1,23,65,18,0,107,2.93457943925234,0.648234584218584,54.0588235294118
9244573247.jpg,0,22,69,8,0,99,2.85858585858586,0.534715278234662,50.8173076923077
11148529964.jpg,1,7,92,21,0,121,3.09917355371901,0.506704362814024,58.2
8488083858.jpg,0,4,47,75,1,127,3.5748031496063,0.570709458778464,74.0807086614173
4630540392.jpg,0,7,45,46,10,108,3.5462962962963,0.753611358468224,70.3445945945946
362016009.jpg,0,31,64,8,0,103,2.77669902912621,0.576195072410062,48.25
5643888483.jpg,1,22,57,26,0,106,3.0188679245283,0.703476158941766,53.3243243243243
3821275434.jpg,0,2,60,64,4,130,3.53846153846154,0.586063548606605,71.3097014925373
6679121211.jpg,0,0,30,73,3,106,3.74528301886792,0.498785587196151,72.2179487179487
4981035833.jpg,0,0,41,59,2,102,3.61764705882353,0.527353145004104,69.925
8929900709.jpg,0,4,60,37,2,103,3.35922330097087,0.591680374301949,62.3175675675676
485174290.jpg,0,1,45,58,0,104,3.54807692307692,0.5191443238415,67.2972972972973
3005232085.jpg,1,25,65,15,0,106,2.88679245283019,0.63726730157508,50.2665094339623
10665464526.jpg,0,0,20,76,9,105,3.8952380952381,0.517460692000434,76.9138655462185
6813687716.jpg,0,7,59,29,0,95,3.23157894736842,0.573392880402916,62.3642857142857
155797839.jpg,0,0,19,71,14,104,3.95192307692308,0.563963224241827,79.4096638655462
8081688318.jpg,0,3,48,50,0,101,3.46534653465347,0.557931114666382,65.0287610619469
6903802628.jpg,0,6,65,32,1,104,3.26923076923077,0.578427215227558,63.7326732673267
7003526811.jpg,0,1,46,54,4,105,3.58095238095238,0.584757549708759,68.6351351351351
2297923850.jpg,0,17,75,14,0,106,2.97169811320755,0.542613554844668,52.9181034482759
11452299875.jpg,0,1,24,77,3,105,3.78095238095238,0.499633565359354,74.4608695652174
7979893598.jpg,1,18,78,8,1,106,2.90566037735849,0.561092503820596,52.1941964285714
8195809276.jpg,0,19,79,11,0,109,2.92660550458716,0.521863151111417,52.9264705882353
8086991348.jpg,0,2,32,68,4,106,3.69811320754717,0.571877631278959,72.6946902654867
4679147725.jpg,0,0,48,53,4,105,3.58095238095238,0.568076247268466,70.0200892857143
6983458217.jpg,0,3,59,36,2,100,3.37,0.580055727033745,67.4759615384615
6897446719.jpg,3,67,38,4,0,112,2.38392857142857,0.603973863080537,37.09375
6078173140.jpg,1,0,35,65,4,105,3.67619047619048,0.596387169276516,71.7142857142857
6511236583.jpg,0,3,49,60,1,113,3.52212389380531,0.568477684144608,68.4558823529412
4340329166.jpg,0,0,36,67,3,106,3.68867924528302,0.523053444363363,72.2629310344828
6828526069.jpg,0,2,56,39,1,98,3.39795918367347,0.551283337227311,64.7640186915888
11153943035.jpg,0,12,59,25,2,98,3.1734693877551,0.658419071952629,60.2777777777778
2128879923.jpg,2,81,20,1,0,104,2.19230769230769,0.463773527692987,31.2008928571429
7904253618.jpg,0,47,51,6,0,104,2.60576923076923,0.59802700252003,43.5641592920354
8503728878.jpg,4,54,46,1,0,105,2.41904761904762,0.584757549708759,36.9159482758621
2264946914.jpg,6,48,50,5,0,109,2.4954128440367,0.675275707904079,39.1737288135593
6948272719.jpg,1,52,46,2,0,101,2.48514851485149,0.558817705269592,40.3577981651376
4170535749.jpg,2,20,62,19,0,103,2.95145631067961,0.677055921702001,53.4071428571429
3391217731.jpg,3,64,29,4,0,100,2.34,0.606696635956396,34.9252336448598
4991538106.jpg,0,10,57,34,1,102,3.25490196078431,0.640022810698134,60.8692660550459
6368218585.jpg,0,1,38,61,5,105,3.66666666666667,0.582875278034323,72.4521739130435
9372862494.jpg,2,30,56,14,3,105,2.86666666666667,0.772939776073076,50.1443965517241
8488319324.jpg,0,0,19,81,10,110,3.91818181818182,0.509214509003966,80.9396551724138
5971597371.jpg,0,1,36,69,2,108,3.66666666666667,0.529503382213656,73.3918918918919
6534779805.jpg,4,88,42,1,0,135,2.2962962962963,0.533561311141816,34.3101503759398
8986202022.jpg,0,2,45,60,1,108,3.55555555555556,0.552535926574701,68.0131578947368
9210757941.jpg,1,21,83,2,0,107,2.80373831775701,0.464580401808248,49.035046728972
8152645114.jpg,0,6,65,34,0,105,3.26666666666667,0.559303596287842,63.0575221238938
2579041082.jpg,0,5,66,35,0,106,3.28301886792453,0.547804570316512,63.5096153846154
3805107589.jpg,0,7,78,23,0,108,3.14814814814815,0.50815434432866,59.4612068965517
899304128.jpg,0,4,69,35,0,108,3.28703703703704,0.53040146892859,63.9929906542056
2564368557.jpg,0,6,54,38,3,101,3.37623762376238,0.645778369853231,66.0917431192661
3722623767.jpg,0,27,67,12,0,106,2.85849056603774,0.592632211413952,51.1991525423729
3636701462.jpg,0,0,30,71,3,104,3.74038461538462,0.502328409725477,77.3325242718447
11232665444.jpg,15,61,30,3,0,109,2.19266055045872,0.700225680818314,32.2668067226891
7179426262.jpg,0,2,57,42,0,101,3.3960396039604,0.530645039942749,65.5486111111111
7287141628.jpg,0,2,52,50,0,104,3.46153846153846,0.538301480532277,67.0717391304348
5071912841.jpg,0,4,58,40,3,105,3.4,0.61394061351492,64.2739130434783
5001719293.jpg,5,56,42,3,0,106,2.40566037735849,0.629108240922058,36.9364406779661
9725681826.jpg,0,3,58,42,2,105,3.40952380952381,0.583346415342582,66.4652777777778
4378419360.jpg,0,5,53,41,1,100,3.38,0.599326221011495,62.6857798165138
22947511.jpg,52,49,3,0,0,104,1.52884615384615,0.556632223656022,13.974358974359
5715854575.jpg,1,31,72,6,0,110,2.75454545454545,0.561556873137655,46.8581081081081
5483567910.jpg,0,2,46,59,0,107,3.53271028037383,0.537600486602462,71.640625
6177166693.jpg,0,1,34,62,5,102,3.69607843137255,0.576593198502975,70.1788990825688
3444483519.jpg,0,2,56,47,3,108,3.47222222222222,0.587380265521398,66.1680672268908
5597328203.jpg,0,34,61,13,0,108,2.80555555555556,0.633316936990578,48.5287610619469
5217952997.jpg,0,1,50,58,1,110,3.53636363636364,0.536336070311266,66.0294117647059
4780164434.jpg,0,10,73,22,0,105,3.11428571428571,0.542683604419273,57.8417431192661
3045035343.jpg,0,3,78,45,1,127,3.34645669291339,0.540105115517363,65.4697580645161
2855163439.jpg,0,24,94,10,0,128,2.890625,0.505627776945549,52.125
8666962145.jpg,0,10,62,32,1,105,3.22857142857143,0.624147770612408,58.6769911504425
9625551668.jpg,0,38,55,12,0,105,2.75238095238095,0.647197395594628,46.9426605504587
7003924615.jpg,2,28,73,5,0,108,2.75,0.565768024851109,45.55
5890423400.jpg,0,5,49,51,2,107,3.46728971962617,0.619155800939241,66.8601694915254
6486604889.jpg,6,39,43,13,2,103,2.66990291262136,0.844687545371162,45.0
2824487894.jpg,9,78,16,1,0,104,2.08653846153846,0.523442246015848,27.6911764705882
288926242.jpg,0,17,71,17,1,106,3.0188679245283,0.601286431633151,53.9663865546218
5886709832.jpg,1,3,37,63,2,106,3.58490566037736,0.630463541158059,70.2282608695652
5360175600.jpg,0,0,31,73,6,110,3.77272727272727,0.536024970476325,75.6183035714286
7052391619.jpg,0,0,35,64,5,104,3.71153846153846,0.551662569637779,76.8175
6912813329.jpg,0,1,38,66,3,108,3.65740740740741,0.549630921823901,72.70625
4372249937.jpg,3,69,33,1,0,106,2.30188679245283,0.537539567903605,35.3630434782609
6727661759.jpg,0,11,59,36,1,107,3.25233644859813,0.645645178914234,60.4138655462185
313550822.jpg,0,11,74,17,0,102,3.05882352941176,0.52319523667414,54.4357798165138
8639922039.jpg,0,11,57,36,0,104,3.24038461538462,0.630844591938848,61.6089108910891
1543375325.jpg,19,79,9,0,0,107,1.90654205607477,0.505306002570194,23.9474789915966
2149726014.jpg,22,65,20,0,0,107,1.98130841121495,0.629184983615971,25.4527027027027
4871847706.jpg,0,1,27,69,8,105,3.8,0.578459492631407,72.5743243243243
5687490427.jpg,0,46,63,3,0,112,2.61607142857143,0.541028978163236,44.2948717948718
10126177964.jpg,0,1,48,54,6,109,3.59633027522936,0.610392497512353,70.9078947368421
6778568929.jpg,0,10,49,49,2,110,3.39090909090909,0.678577229119796,61.7310924369748
8108912190.jpg,0,2,51,54,4,111,3.54054054054054,0.599754249426513,67.2796610169491
7999186610.jpg,0,17,84,8,0,109,2.91743119266055,0.473920613116298,52.2522123893805
7793934458.jpg,0,11,67,24,0,102,3.12745098039216,0.574569466497057,59.1880530973451
7721291102.jpg,0,2,43,56,4,105,3.59047619047619,0.599603043290984,70.2584033613445
9906667675.jpg,4,65,37,0,0,106,2.31132075471698,0.540955196581007,35.4682203389831
4936086328.jpg,0,0,34,70,2,106,3.69811320754717,0.500852821661969,73.1875
9237488355.jpg,0,0,34,88,3,125,3.752,0.486196561869984,77.6168032786885
3078720945.jpg,0,34,57,8,1,100,2.76,0.63754579950357,46.6448598130841
9829643193.jpg,0,3,46,48,8,105,3.58095238095238,0.676258831606662,69.1554054054054
8074309631.jpg,0,3,52,46,3,104,3.47115384615385,0.60670574383033,70.2839805825243
4713092038.jpg,0,1,29,74,4,108,3.75,0.531705068975115,73.9358407079646
6712830935.jpg,0,1,13,65,29,108,4.12962962962963,0.642608477952408,83.5
4671409819.jpg,0,39,60,12,0,111,2.75675675675676,0.635555822828494,48.2760869565217
3048478105.jpg,0,0,30,76,3,109,3.75229357798165,0.493587834180471,75.3898305084746
25239707.jpg,0,0,10,67,25,102,4.14705882352941,0.569819475035116,84.275641025641
9197349207.jpg,0,12,62,26,1,101,3.15841584158416,0.628214505838997,58.5957943925234
5480693901.jpg,0,1,41,71,6,119,3.6890756302521,0.578541403227582,74.474358974359
8178731250.jpg,0,2,45,62,1,110,3.56363636363636,0.550683857210433,67.4159663865546
3561898679.jpg,0,3,44,59,0,106,3.52830188679245,0.555621439639331,68.4864864864865
8350811947.jpg,1,2,24,64,20,111,3.9009009009009,0.737994271411062,80.5066371681416
4542216557.jpg,0,0,47,53,2,102,3.55882352941176,0.537200838445943,71.6009615384615
6293629106.jpg,0,37,57,2,0,96,2.63541666666667,0.525553175569207,44.8183962264151
6323869799.jpg,0,3,36,67,4,110,3.65454545454545,0.597185503372164,69.13125
9605303857.jpg,0,6,54,44,0,104,3.36538461538462,0.592144240950727,67.0
2941933060.jpg,0,0,19,86,9,114,3.91228070175439,0.489923301000493,79.4789915966387
8919875155.jpg,0,21,72,13,0,106,2.92452830188679,0.563967462883609,49.9054054054054
3376034906.jpg,6,69,34,0,0,109,2.25688073394495,0.55115484355109,33.3760504201681
7289957138.jpg,2,16,85,24,0,127,3.03149606299213,0.616402876320964,56.6875
9408208696.jpg,0,1,23,74,5,103,3.80582524271845,0.525025721632918,78.1486486486486
9052518863.jpg,0,20,72,16,0,108,2.96296296296296,0.578847161173496,52.975
141087919.jpg,0,1,11,76,11,99,3.97979797979798,0.514678381440689,79.5483193277311
5212871853.jpg,1,12,68,28,0,109,3.12844036697248,0.625106175147288,59.3289473684211
5155188582.jpg,1,15,61,21,0,98,3.04081632653061,0.640849425789569,55.7224770642202
9141979363.jpg,0,2,84,45,0,131,3.32824427480916,0.502956613690914,64.744140625
2725531194.jpg,0,0,45,66,0,111,3.59459459459459,0.493196961916072,68.1785714285714
6255855320.jpg,1,15,65,20,0,101,3.02970297029703,0.62378594957813,54.1330275229358
326195053.jpg,0,31,60,17,0,108,2.87037037037037,0.656991053760519,50.9194915254237
9485678546.jpg,1,32,66,8,0,107,2.75700934579439,0.596232218520937,46.1578947368421
4602769821.jpg,0,0,20,82,5,107,3.85981308411215,0.464770142637808,75.3886554621849
4948125167.jpg,0,9,44,48,2,103,3.41747572815534,0.679161418403784,63.90625
3248976854.jpg,0,2,32,72,5,111,3.72072072072072,0.57479120590431,73.8397435897436
7946509460.jpg,0,9,97,21,0,127,3.09448818897638,0.47864011841323,58.618
1317678723.jpg,2,57,39,3,0,101,2.42574257425743,0.5890082283545,38.9197247706422
6228278450.jpg,0,8,55,42,0,105,3.32380952380952,0.612297660381309,62.6239130434783
3867707916.jpg,0,13,69,22,0,104,3.08653846153846,0.576406290821484,58.127358490566
4356674628.jpg,0,3,77,29,0,109,3.23853211009174,0.488745229564809,60.7212389380531
4414969933.jpg,0,3,57,37,0,97,3.35051546391753,0.540856518122761,66.8382352941177
5200236444.jpg,0,6,57,42,2,107,3.37383177570093,0.622280718155662,65.7364864864865
2952908030.jpg,0,22,75,6,1,104,2.86538461538462,0.540723935947584,50.2179487179487
86243803.jpg,4,44,45,6,0,99,2.53535353535354,0.674811104531185,39.01875
6749191929.jpg,0,8,74,24,0,106,3.15094339622642,0.530811648599867,57.8891304347826
6860584767.jpg,0,0,22,77,3,102,3.81372549019608,0.460958797515768,77.8783185840708
4976232823.jpg,0,2,32,67,2,103,3.66990291262136,0.549301687074422,74.3774038461538
3114317948.jpg,0,6,77,24,0,107,3.16822429906542,0.504432827557042,59.2897196261682
3817723435.jpg,0,21,65,18,0,104,2.97115384615385,0.614654860438597,55.3529411764706
5963098166.jpg,7,55,43,3,0,108,2.38888888888889,0.653292642893341,37.0394736842105
375446021.jpg,0,27,75,5,0,107,2.79439252336449,0.509130182355242,48.2165178571429
5200584536.jpg,0,34,65,6,0,105,2.73333333333333,0.559303596287842,46.1924778761062
8043238323.jpg,0,2,26,76,3,107,3.74766355140187,0.533649908982546,75.6216216216216
4346944645.jpg,0,3,45,54,2,104,3.52884615384615,0.59048656535823,68.004347826087
9118228667.jpg,0,0,54,59,1,114,3.53508771929825,0.518333349557771,68.2801724137931
4683892759.jpg,0,16,74,11,0,101,2.95049504950495,0.517227950206916,52.4275700934579
9232503869.jpg,4,67,31,0,0,102,2.26470588235294,0.525139690764791,32.8100961538462
8670524662.jpg,0,5,64,36,0,105,3.2952380952381,0.553377905438143,61.84375
4512474932.jpg,0,2,33,66,2,103,3.66019417475728,0.552239612285735,74.8680555555556
6114886448.jpg,0,0,32,72,2,106,3.71698113207547,0.492896530842733,72.5233050847458
5546833927.jpg,1,10,91,36,1,139,3.18705035971223,0.596710127035223,62.1734693877551
8283257984.jpg,5,52,45,3,0,105,2.43809523809524,0.634335047416547,37.1565217391304
11461273913.jpg,0,2,38,62,2,104,3.61538461538462,0.562720374224038,70.7754237288136
7652900928.jpg,0,3,78,25,0,106,3.20754716981132,0.472419932890129,60.4717391304348
8083395637.jpg,0,0,35,63,10,108,3.76851851851852,0.605372851533239,74.5263157894737
4236326911.jpg,0,19,67,16,0,102,2.97058823529412,0.587929448736755,51.5596330275229
9255279783.jpg,0,3,40,56,8,107,3.64485981308411,0.662361932193293,71.5756302521008
5526408007.jpg,0,10,77,18,0,105,3.07619047619048,0.513195833352107,56.0245535714286
6099389158.jpg,6,61,36,2,0,105,2.32380952380952,0.612297660381309,36.4605263157895
9265763356.jpg,2,19,51,29,1,102,3.07843137254902,0.766711823305287,52.4712389380531
2259747766.jpg,0,17,82,8,0,107,2.91588785046729,0.478233686603045,51.5951327433628
5327737580.jpg,0,14,81,8,0,103,2.94174757281553,0.460716465025955,52.3982300884956
5304364574.jpg,0,6,66,32,0,104,3.25,0.553014685807209,62.5855263157895
7288524676.jpg,0,8,54,44,2,108,3.37037037037037,0.649839557374613,64.25
5419570020.jpg,0,3,60,38,2,103,3.37864077669903,0.579325247371913,66.7053571428571
3697066196.jpg,0,3,66,28,0,97,3.25773195876289,0.505765725481833,64.997572815534
9195069146.jpg,0,0,31,67,8,106,3.78301886792453,0.569121578460334,74.8305084745763
4804146129.jpg,4,43,51,4,0,102,2.53921568627451,0.639795273992229,39.8819444444444
5297588508.jpg,2,13,63,23,0,101,3.05940594059406,0.660632759984211,53.1283185840708
9122759800.jpg,0,1,36,61,3,101,3.65346534653465,0.555619358272486,74.8080357142857
5248435224.jpg,0,12,72,23,0,107,3.10280373831776,0.565261326094706,58.825
8475086246.jpg,0,0,54,52,0,106,3.49056603773585,0.502285879874493,69.4029126213592
5174701484.jpg,2,8,82,15,0,107,3.02803738317757,0.540054922525507,56.171875
6015806731.jpg,0,0,13,84,15,112,4.01785714285714,0.50192678941306,80.7021739130435
5184506144.jpg,0,1,17,70,19,107,4.0,0.614295116833951,81.5588235294118
198187235.jpg,0,15,46,37,1,99,3.24242424242424,0.715583237088619,60.1365546218487
6915332491.jpg,0,1,22,71,13,107,3.89719626168224,0.597709139828855,76.4385593220339
5274682163.jpg,9,85,16,1,0,111,2.08108108108108,0.50695409753,28.8081896551724
8856278655.jpg,0,7,67,28,0,102,3.20588235294118,0.551114717247404,59.5602678571429
8157886874.jpg,0,3,49,56,3,111,3.53153153153153,0.600300225187664,71.1961206896552
9239005893.jpg,0,0,40,65,3,108,3.65740740740741,0.532355671933666,72.9137168141593
7980394491.jpg,0,14,78,27,2,121,3.1404958677686,0.623241327309186,58.75
4468108530.jpg,0,13,57,34,0,104,3.20192307692308,0.64431506030669,60.6957547169811
2910782740.jpg,0,10,72,27,0,109,3.15596330275229,0.563952846837089,56.1155462184874
8465039467.jpg,1,26,65,9,0,101,2.81188118811881,0.595195283703235,49.3646788990826
3022463774.jpg,0,2,36,65,4,107,3.66355140186916,0.581863065548848,71.1596638655462
1679551869.jpg,0,1,50,53,0,104,3.5,0.521387245906701,67.1398305084746
8533373653.jpg,0,3,76,28,1,108,3.25,0.513827492052328,59.6184210526316
5315386438.jpg,0,29,74,11,0,114,2.84210526315789,0.573437814304837,50.4300847457627
6188375845.jpg,5,48,45,7,0,105,2.51428571428571,0.694958295847336,39.6185344827586
4669754441.jpg,0,0,26,75,3,104,3.77884615384615,0.481839734247422,73.6717391304348
3651951998.jpg,0,12,73,20,0,105,3.07619047619048,0.549391938265845,56.8276699029126
7448606010.jpg,0,30,63,13,0,106,2.83962264150943,0.619320556321587,50.5
5073919092.jpg,0,26,74,6,0,106,2.81132075471698,0.518481437371168,47.1852678571429
3326988489.jpg,0,12,73,18,1,104,3.07692307692308,0.569317555905564,57.375
6694669509.jpg,0,3,70,34,0,107,3.28971962616822,0.514127687583038,64.6869158878505
3876341199.jpg,0,2,43,81,0,126,3.62698412698413,0.517441814841081,73.9807692307692
5016823142.jpg,1,26,60,11,0,98,2.8265306122449,0.62632145173936,49.2184466019417
11256776836.jpg,0,2,47,58,3,110,3.56363636363636,0.583052277500553,69.578125
5669648365.jpg,0,5,71,21,1,98,3.18367346938776,0.524589948367337,59.052752293578
6149786725.jpg,1,3,44,54,3,105,3.52380952380952,0.651850001847377,69.8986486486486
10329235193.jpg,0,2,17,66,27,112,4.05357142857143,0.682328891058202,84.1292372881356
9098295579.jpg,0,2,30,70,5,107,3.72897196261682,0.575770090678299,75.8340707964602
9215861266.jpg,0,9,78,19,0,106,3.09433962264151,0.507623818098411,56.275
6114724699.jpg,1,27,69,6,0,103,2.77669902912621,0.558921209413618,44.6808035714286
6622490475.jpg,0,2,28,68,4,102,3.72549019607843,0.565630512031092,71.6315789473684
7617916556.jpg,0,2,44,63,1,110,3.57272727272727,0.549546784229254,70.1890756302521
5217753146.jpg,0,6,67,36,0,109,3.27522935779817,0.558960007067151,59.5961538461538
5937141958.jpg,0,2,67,39,0,108,3.34259259259259,0.514500702288051,65.1184210526316
2417107784.jpg,0,5,62,34,1,102,3.30392156862745,0.576593198502975,61.5257009345794
5871068150.jpg,0,3,66,40,0,109,3.3394495412844,0.530900414150486,62.7710084033613
6045753888.jpg,0,10,57,39,2,108,3.30555555555556,0.662173330970994,64.0066371681416
5399180378.jpg,2,3,48,49,3,105,3.45714285714286,0.693771346567932,69.8589108910891
8434827647.jpg,0,0,20,85,3,108,3.84259259259259,0.435826361656464,77.5657894736842
992920521.jpg,0,3,57,46,0,106,3.40566037735849,0.548214450336683,65.7364864864865
5684894057.jpg,0,8,67,24,1,100,3.18,0.575246982529323,60.325
6344257116.jpg,0,0,32,75,4,111,3.74774774774775,0.512896737231836,72.5
9202851539.jpg,0,2,58,46,0,106,3.41509433962264,0.532164037157572,65.8214285714286
4761960995.jpg,0,18,67,19,0,104,3.00961538461538,0.599274517831503,55.9191176470588
4270305165.jpg,4,47,91,8,0,150,2.68666666666667,0.614551363252953,47.0096153846154
9496059717.jpg,0,1,49,48,4,102,3.53921568627451,0.59155054900552,70.0663716814159
10440370734.jpg,4,60,39,6,0,109,2.43119266055046,0.657815865222348,39.2436440677966
10678199353.jpg,0,1,50,57,0,108,3.51851851851852,0.520270984055541,70.3611111111111
6230011878.jpg,0,1,25,62,10,98,3.8265306122449,0.609639241033473,77.4797297297297
5062110567.jpg,0,25,77,6,0,108,2.82407407407407,0.508409719674872,48.6184210526316
6124044226.jpg,0,0,35,58,4,97,3.68041237113402,0.550499616874248,71.9797297297297
7900291786.jpg,0,3,71,32,0,106,3.27358490566038,0.507712308261743,64.0535714285714
5644717504.jpg,1,31,70,7,0,109,2.76146788990826,0.575729530261347,46.5575221238938
4125943270.jpg,1,1,30,69,8,109,3.75229357798165,0.640543220023157,76.7232142857143
255478501.jpg,68,29,2,0,0,99,1.33333333333333,0.515078753637713,8.76470588235294
8864018641.jpg,0,6,54,50,0,110,3.4,0.593543240195398,66.2887931034483
4909946838.jpg,0,0,50,61,0,111,3.54954954954955,0.499795207855427,70.4551282051282
8006234274.jpg,0,0,26,79,5,110,3.80909090909091,0.497617342124099,76.3451327433628
2464934588.jpg,0,48,50,2,0,100,2.54,0.539734315485991,40.7986111111111
4688672987.jpg,0,12,56,38,0,106,3.24528301886792,0.644557001871267,61.2943925233645
6022545118.jpg,2,32,54,12,0,100,2.76,0.683425714376264,45.8073394495413
3872832716.jpg,0,25,58,19,0,102,2.94117647058824,0.657380481352061,52.3
8995226934.jpg,0,0,15,80,6,101,3.91089108910891,0.449422071131138,77.4021739130435
352744670.jpg,48,51,7,0,0,106,1.61320754716981,0.610554076494007,14.3783783783784
9652506914.jpg,0,1,32,66,3,102,3.69607843137255,0.541161488064193,75.9800884955752
3128928410.jpg,0,3,28,67,3,101,3.69306930693069,0.578663533625988,72.5252293577982
10770026303.jpg,0,0,39,66,1,106,3.64150943396226,0.501211470344994,72.0825892857143
6087844508.jpg,0,2,42,61,4,109,3.61467889908257,0.591737192678284,71.891592920354
5041593593.jpg,4,29,51,17,0,101,2.8019801980198,0.761837278953951,47.8986486486486
10806677866.jpg,0,7,63,33,0,103,3.25242718446602,0.572549280385056,60.9054054054054
113701797.jpg,1,28,66,10,0,105,2.80952380952381,0.605983594840749,48.09375
8391500206.jpg,0,37,61,6,0,104,2.70192307692308,0.572506118885479,46.2635135135135
6379014005.jpg,1,40,53,10,0,104,2.69230769230769,0.65473515103323,44.7544642857143
313424539.jpg,0,0,26,75,7,108,3.82407407407407,0.526471302014582,75.1052631578947
6045595814.jpg,0,7,49,45,1,102,3.3921568627451,0.631779864298186,66.0917431192661
5456373866.jpg,11,54,39,3,0,107,2.31775700934579,0.694970215747321,34.2946428571429
2715023572.jpg,0,2,31,73,1,107,3.68224299065421,0.524820379715343,75.472972972973
3951898034.jpg,0,1,37,68,4,110,3.68181818181818,0.557382779577142,71.95
7981422171.jpg,4,24,58,19,0,105,2.87619047619048,0.742853620729886,49.1621621621622
2413968824.jpg,22,53,24,1,0,100,2.04,0.709531072916714,27.7361111111111
3530486052.jpg,0,0,17,79,9,105,3.92380952380952,0.494104436469856,77.6474358974359
290784782.jpg,0,3,35,62,6,106,3.66981132075472,0.628250755415498,71.5444915254237
2194214783.jpg,1,0,23,73,7,104,3.81730769230769,0.587316144781357,75.1113445378151
9694884270.jpg,0,24,84,18,0,126,2.95238095238095,0.577680089421719,54.1011904761905
4463917829.jpg,0,26,75,9,0,110,2.84545454545455,0.544974768145213,50.1316964285714
5678053727.jpg,0,6,56,46,0,108,3.37037037037037,0.589512591204502,63.0483193277311
7964487966.jpg,0,0,14,79,8,101,3.94059405940594,0.465226443320193,79.975
5360940013.jpg,2,63,41,0,0,106,2.36792452830189,0.522365894352903,35.0668103448276
4530384020.jpg,0,7,64,36,0,107,3.27102803738318,0.575770090678299,63.6214285714286
2700852747.jpg,0,15,58,26,1,100,3.13,0.661418738375885,55.5116822429907
7003816113.jpg,44,61,3,0,0,108,1.62037037037037,0.542021011983518,16.1016949152542
4976142964.jpg,0,17,68,13,0,98,2.95918367346939,0.554612660358259,52.6554054054054
4409503429.jpg,8,80,16,1,0,105,2.0952380952381,0.509973783711732,29.1689189189189
5993545370.jpg,0,1,36,66,0,103,3.63106796116505,0.504689601017511,72.4026548672566
9618688199.jpg,1,9,51,47,3,111,3.37837837837838,0.714194448363826,64.8289473684211
7934781744.jpg,0,11,65,43,1,120,3.28333333333333,0.637528491152209,63.1546610169492
2515829883.jpg,0,1,34,68,2,105,3.67619047619048,0.527972138237027,73.0260869565217
8848421856.jpg,0,15,63,30,0,108,3.13888888888889,0.633316936990578,56.1155462184874
5906203942.jpg,0,20,74,15,0,109,2.95412844036697,0.567406724279621,53.858407079646
7322656062.jpg,0,0,23,80,4,107,3.82242990654206,0.472110558528953,79.15
482147713.jpg,0,4,32,68,1,105,3.62857142857143,0.576079970028582,73.8082524271845
4893296719.jpg,0,11,55,38,0,104,3.25961538461538,0.638493255283538,61.6799065420561
8851705236.jpg,9,72,20,1,0,102,2.12745098039216,0.557070993350661,29.2
2654797164.jpg,0,3,45,48,2,98,3.5,0.596380837295082,71.6357142857143
11436390143.jpg,0,1,45,54,3,103,3.57281553398058,0.570550847480092,72.4481132075472
11221904805.jpg,0,2,25,78,1,106,3.73584905660377,0.503357996099393,78.1297169811321
2585752058.jpg,0,10,58,30,1,99,3.22222222222222,0.63173805530579,58.6728971962617
1427484100.jpg,0,1,45,55,2,103,3.56310679611651,0.554304066633732,71.65
8145791705.jpg,1,16,59,34,1,111,3.16216216216216,0.707627798165887,58.54375
7188178353.jpg,0,19,65,15,0,99,2.95959595959596,0.587613504783473,52.0894495412844
6844773508.jpg,0,1,34,69,1,105,3.66666666666667,0.512660231362364,75.5767326732673
11515148456.jpg,0,5,63,35,3,106,3.33962264150943,0.615464090520783,64.4316037735849
3754591467.jpg,10,46,37,6,0,99,2.39393939393939,0.753470633992742,38.0871559633027
5397802120.jpg,0,1,36,56,7,100,3.69,0.614554121031474,71.5337837837838
8497829320.jpg,0,5,58,37,0,100,3.32,0.566399223876658,62.0347222222222
1465706268.jpg,0,4,78,21,1,104,3.18269230769231,0.497848245231476,59.78125
3131665013.jpg,1,24,67,10,0,102,2.84313725490196,0.592779959162309,49.125
3170684406.jpg,0,2,42,60,2,106,3.58490566037736,0.56682784029993,69.8424369747899
4696642475.jpg,0,1,51,50,4,106,3.5377358490566,0.588371898941911,68.3865546218487
9849484955.jpg,0,43,61,2,0,106,2.61320754716981,0.526818930074988,45.4910714285714
3204890107.jpg,13,69,18,0,0,100,2.05,0.557320429022713,27.3394495412844
7225479532.jpg,0,10,63,32,1,106,3.22641509433962,0.621565134585182,61.1298076923077
11208321473.jpg,0,1,46,54,3,104,3.56730769230769,0.57054603512134,72.8470873786408
8412287695.jpg,0,1,49,51,1,102,3.50980392156863,0.540353716921064,65.9868421052632
7967382050.jpg,12,55,36,2,0,105,2.26666666666667,0.683130051063973,33.7027027027027
8310254529.jpg,0,2,30,75,2,109,3.70642201834862,0.532338521744318,71.19375
507507455.jpg,0,2,43,59,4,108,3.60185185185185,0.594991790013488,72.15625
4460254023.jpg,0,3,37,61,0,101,3.57425742574257,0.55401326073417,69.2916666666667
5780359774.jpg,0,0,46,54,3,103,3.58252427184466,0.551722291692297,69.1172566371681
3385195104.jpg,0,1,48,55,2,106,3.54716981132075,0.554326283006989,70.0063559322034
6163576407.jpg,0,3,68,38,1,110,3.33636363636364,0.546503023439813,63.5067567567568
4232963375.jpg,35,57,13,1,0,106,1.81132075471698,0.677716158413434,21.0902777777778
6769268131.jpg,0,4,43,50,2,99,3.50505050505051,0.612351395946061,67.9839449541284
6799306335.jpg,28,68,12,0,0,108,1.85185185185185,0.593025110417193,21.5114678899083
5344616817.jpg,0,4,78,30,1,113,3.24778761061947,0.526629672189905,58.5384615384615
6290086775.jpg,0,1,52,52,1,106,3.5,0.538958431120797,69.3571428571429
6232083444.jpg,0,15,73,14,0,102,2.99019607843137,0.535753342818227,54.0573394495413
11158314215.jpg,1,39,60,7,0,107,2.68224299065421,0.608092142365009,46.3349514563107
271262860.jpg,1,6,75,31,0,113,3.20353982300885,0.569449797664976,58.8910256410256
2824866912.jpg,0,10,52,42,1,105,3.32380952380952,0.657723903017621,62.9826086956522
11548683805.jpg,1,52,56,5,0,114,2.57017543859649,0.594507280865439,42.3910256410256
517716589.jpg,0,0,21,75,14,110,3.93636363636364,0.563040121556243,80.353813559322
4131278870.jpg,0,0,20,75,6,101,3.86138613861386,0.490503883171113,80.40625
5674214513.jpg,0,2,27,81,0,110,3.71818181818182,0.49086738771988,71.95
9527980922.jpg,0,2,38,59,2,101,3.6039603960396,0.567083907738389,70.7430555555556
16079437.jpg,2,23,59,23,0,107,2.96261682242991,0.712757515792089,53.0868644067797
9379457487.jpg,0,1,23,74,7,105,3.82857142857143,0.545208902396822,76.5758928571429
7369281846.jpg,0,3,58,43,0,104,3.38461538461538,0.545194225793602,67.3235294117647
9723327327.jpg,0,0,21,84,6,111,3.86486486486486,0.476473532346789,75.3898305084746
5292219744.jpg,6,77,20,0,0,103,2.13592233009709,0.486051390999508,29.9115044247788
6458754563.jpg,0,2,47,49,5,103,3.55339805825243,0.621953836944761,69.0625
3545028223.jpg,0,9,71,26,1,107,3.17757009345794,0.579737808534454,58.4004237288136
3049913075.jpg,0,1,64,71,1,137,3.52554744525547,0.529709853582502,71.2103448275862
6307302399.jpg,0,1,20,81,2,104,3.80769230769231,0.463773527692987,80.107476635514
5461710344.jpg,0,16,83,7,0,106,2.91509433962264,0.460184735747802,52.225
8529310556.jpg,0,3,45,54,1,103,3.51456310679612,0.575037554952665,70.975
5430572465.jpg,0,2,43,58,1,104,3.55769230769231,0.554363504117592,69.9203539823009
5204128955.jpg,0,24,66,15,2,107,2.95327102803738,0.664222876468738,51.1292372881356
4077667734.jpg,0,2,34,60,11,107,3.74766355140187,0.660095161005968,76.2019230769231
348162485.jpg,12,83,12,0,0,107,2.0,0.475830951430886,26.3046218487395
4701833798.jpg,0,4,62,37,0,103,3.32038834951456,0.546173717839859,63.2765486725664
5409949181.jpg,0,5,41,61,2,109,3.55045871559633,0.615934077342428,69.703781512605
7281146720.jpg,0,0,30,67,5,102,3.75490196078431,0.534665149393819,73.1327433628319
8523540447.jpg,0,5,43,49,5,102,3.52941176470588,0.670538166498752,66.545871559633
3107928091.jpg,0,29,61,9,1,100,2.82,0.625711715980412,47.0940366972477
5058695994.jpg,0,1,13,73,20,107,4.04672897196262,0.588941768753835,80.9348739495798
2785267250.jpg,0,1,28,69,2,100,3.72,0.514045157785213,74.1146788990826
5198400630.jpg,0,14,64,23,1,102,3.1078431372549,0.627849744670753,58.4326923076923
8481450412.jpg,5,52,38,4,0,99,2.41414141414141,0.654811096145075,37.225
7797268116.jpg,0,5,51,48,1,105,3.42857142857143,0.602193791596495,64.8445945945946
5667961686.jpg,0,1,36,99,2,138,3.73913043478261,0.487872602523692,77.298275862069
6642387989.jpg,0,1,21,72,8,102,3.85294117647059,0.552170493535534,82.5660377358491
6121672426.jpg,1,27,75,3,0,106,2.75471698113208,0.512906206123813,47.2589285714286
6261187277.jpg,0,24,63,13,1,101,2.91089108910891,0.634019083324628,50.725
8639628841.jpg,0,2,40,61,3,106,3.61320754716981,0.578516241974426,71.1949152542373
11408091114.jpg,0,1,51,52,4,108,3.5462962962963,0.586200489757354,68.2411504424779
4982617348.jpg,0,10,84,14,0,108,3.03703703703704,0.472138224769331,56.7453271028037
5043851130.jpg,7,50,39,6,0,102,2.43137254901961,0.710735275690091,38.5216346153846
8497413134.jpg,0,4,47,54,1,106,3.49056603773585,0.589516073028878,68.5072115384615
5815446993.jpg,0,5,68,33,0,106,3.26415094339623,0.539874532027984,62.1758474576271
8645014360.jpg,2,37,63,7,0,109,2.68807339449541,0.619098025302731,44.0022123893805
6243575043.jpg,1,24,75,12,0,112,2.875,0.587021800783067,51.4871794871795
3994759840.jpg,0,18,82,5,0,105,2.87619047619048,0.453516984993567,49.8599137931034
7745366610.jpg,3,55,64,5,0,127,2.55905511811024,0.612742252800029,43.768
2260527943.jpg,2,12,62,28,0,104,3.11538461538462,0.672738098864579,58.447247706422
8906425755.jpg,0,48,50,5,0,103,2.58252427184466,0.586185272268683,42.25
7167005638.jpg,4,77,18,1,0,100,2.16,0.486587789373795,29.695652173913
4908441792.jpg,2,32,66,7,0,107,2.72897196261682,0.607657013763768,46.2193396226415
7741343046.jpg,0,17,80,9,0,106,2.92452830188679,0.491801609392343,53.2991071428571
7266979612.jpg,0,2,54,48,1,105,3.45714285714286,0.555195243352965,69.3455882352941
8040267298.jpg,0,0,30,64,6,100,3.76,0.552679423766206,74.35
5847384440.jpg,0,1,79,67,1,148,3.45945945945946,0.526551848050522,69.9464285714286
3307215666.jpg,0,27,61,15,1,104,2.90384615384615,0.661261383174813,50.5705128205128
8607422328.jpg,15,86,6,0,0,107,1.91588785046729,0.437002986197275,24.44375
6841095.jpg,9,79,14,0,0,102,2.04901960784314,0.474653620040621,27.0192307692308
11150131936.jpg,0,5,69,31,2,107,3.2803738317757,0.579433564058746,63.9158878504673
2208434983.jpg,10,77,21,0,0,108,2.10185185185185,0.52844003921284,29.9096638655462
11143825565.jpg,1,7,60,38,3,109,3.32110091743119,0.678788871678054,62.3550420168067
8814635311.jpg,0,6,60,32,4,102,3.33333333333333,0.64995557096191,62.0789473684211
2596393826.jpg,0,18,68,19,0,105,3.00952380952381,0.596387169276516,53.472972972973
5036248276.jpg,0,3,62,34,2,101,3.34653465346535,0.573334868368503,61.3233944954128
4632834953.jpg,0,2,59,50,0,111,3.43243243243243,0.532944165958765,66.2948717948718
656718644.jpg,16,85,24,2,0,127,2.09448818897638,0.609879910975738,27.9711538461538
9130643186.jpg,0,0,31,101,1,133,3.77443609022556,0.437218157760525,78.25
8272706512.jpg,0,7,67,35,1,110,3.27272727272727,0.589029537881659,59.09375
5950764081.jpg,0,1,40,62,1,104,3.60576923076923,0.529118505469683,70.8739130434783
2255689742.jpg,0,8,72,22,0,102,3.13725490196078,0.527261103264158,58.75
8208615482.jpg,0,0,36,61,3,100,3.67,0.532859638121892,71.6597222222222
331406867.jpg,34,67,6,0,0,107,1.73831775700935,0.555189048171896,19.4411764705882
8463190672.jpg,0,2,57,48,0,107,3.42990654205607,0.533980240124661,67.7236842105263
688110993.jpg,0,0,41,59,1,101,3.6039603960396,0.511452987493319,69.3571428571429
5423639636.jpg,1,6,83,35,0,125,3.216,0.562023992140848,62.5423387096774
125829275.jpg,10,60,28,5,0,103,2.27184466019417,0.702853773279595,34.1386554621849
3969622447.jpg,1,39,58,6,0,104,2.66346153846154,0.601140936628686,45.373786407767
4018505209.jpg,0,1,42,62,2,107,3.60747663551402,0.545254127107898,73.1327433628319
4264601430.jpg,0,2,30,69,8,109,3.76146788990826,0.607043267858221,73.8869565217391
8157038620.jpg,0,3,32,65,5,105,3.68571428571429,0.609449400220044,71.3108108108108
8430770537.jpg,0,1,32,62,10,105,3.77142857142857,0.624147770612408,74.2543103448276
3864280906.jpg,0,1,37,69,2,109,3.6605504587156,0.530900414150486,74.0921052631579
4078925567.jpg,2,54,93,1,0,150,2.62,0.526734909066724,44.6539735099338
6569878593.jpg,1,3,59,44,2,109,3.39449541284404,0.623881942533605,65.0588235294118
8247844062.jpg,1,4,55,40,3,103,3.38834951456311,0.660258560594255,66.688679245283
4972553952.jpg,0,1,65,42,0,108,3.37962962962963,0.506363110683967,65.5878378378378
2985434942.jpg,0,28,62,11,0,101,2.83168316831683,0.601154005737183,49.125
9162580665.jpg,0,2,40,56,3,101,3.59405940594059,0.586143631233543,69.9027777777778
3733759776.jpg,0,7,53,52,2,114,3.42982456140351,0.637601954305946,68.9888392857143
9297541584.jpg,0,19,57,33,0,109,3.12844036697248,0.68178574661058,55.5875
6573749079.jpg,0,2,37,66,2,107,3.63551401869159,0.556141073532199,73.1689189189189
4585004484.jpg,0,13,109,16,0,138,3.02173913043478,0.459568050199534,57.4347826086956
5732196042.jpg,0,3,41,60,3,107,3.58878504672897,0.598004086375219,69.9203539823009
5588363134.jpg,1,7,62,36,0,106,3.25471698113208,0.618158875474536,64.3482142857143
4932950485.jpg,0,36,54,6,0,96,2.6875,0.586021375575652,44.4711538461538
138750201.jpg,0,20,54,27,3,104,3.125,0.746350343304977,56.34375
3471964559.jpg,0,1,28,75,6,110,3.78181818181818,0.548255250635938,72.8235294117647
5663852709.jpg,0,17,77,10,1,105,2.95238095238095,0.543863535997354,51.3608695652174
2183577836.jpg,3,57,68,2,0,130,2.53076923076923,0.573152056321942,42.6976744186046
8883794004.jpg,0,5,78,24,0,107,3.17757009345794,0.491687201381957,59.9399038461538
10319186405.jpg,0,18,57,26,1,102,3.09803921568627,0.682305409412992,55.5540540540541
2332998569.jpg,53,45,2,0,0,100,1.49,0.541136103793013,12.5347222222222
8385499383.jpg,0,2,50,53,0,105,3.48571428571429,0.53912831557927,69.5631067961165
6252006096.jpg,5,64,56,4,0,129,2.45736434108527,0.625096891714403,38.447265625
4714961173.jpg,0,9,53,44,2,108,3.36111111111111,0.662173330970994,66.2860576923077
9641836616.jpg,0,1,36,88,1,126,3.70634920634921,0.490998335108547,76.0548780487805
2181528959.jpg,0,1,36,64,3,104,3.66346153846154,0.550561530172921,71.1949152542373
7229767436.jpg,0,0,43,54,4,101,3.61386138613861,0.565160101735835,68.8922018348624
9935622.jpg,2,56,43,5,0,106,2.4811320754717,0.620769600315327,39.8728813559322
4046716515.jpg,2,59,67,1,0,129,2.51937984496124,0.546305420440893,41.0534351145038
102995966.jpg,46,51,7,0,0,104,1.625,0.610387430681514,16.4600840336134
5628057241.jpg,0,5,47,56,0,108,3.47222222222222,0.587380265521398,69.4672897196262
7627340946.jpg,66,36,4,0,0,106,1.41509433962264,0.56682784029993,10.7881355932203
6628854085.jpg,2,18,64,18,0,102,2.96078431372549,0.658855422585499,52.6
2741661469.jpg,0,4,53,50,0,107,3.42990654205607,0.568217164383648,69.0046728971963
3490117565.jpg,0,1,49,58,2,110,3.55454545454545,0.551667424682855,67.55
9135317445.jpg,14,78,15,0,0,107,2.00934579439252,0.522969155676269,25.8193277310924
6813135887.jpg,0,0,54,46,1,101,3.47524752475248,0.521422274283341,66.1
11159983896.jpg,0,1,45,55,5,106,3.60377358490566,0.59648566474642,71.0878378378378
9654462771.jpg,0,0,18,79,14,111,3.96396396396396,0.538143744364542,79.9539473684211
5602815566.jpg,0,7,51,37,5,100,3.4,0.696310623822791,66.7729357798165
5956264742.jpg,0,10,42,53,5,110,3.48181818181818,0.726078042938244,65.6016949152542
4132747677.jpg,0,3,61,36,0,100,3.33,0.532859638121892,62.6458333333333
4718032191.jpg,0,9,78,25,0,112,3.14285714285714,0.534522483824849,58.8205128205128
3579701723.jpg,23,78,8,0,0,109,1.86238532110092,0.517613646641916,22.1449579831933
5483514140.jpg,0,0,28,76,8,112,3.82142857142857,0.540508364550718,74.760593220339
5164262533.jpg,1,3,55,42,2,103,3.39805825242718,0.631521751061341,64.3716814159292
8128896956.jpg,4,34,52,12,1,103,2.72815533980583,0.756594210368004,47.8028846153846
5901488995.jpg,3,61,62,2,0,128,2.4921875,0.575019256781276,41.4055118110236
6435747701.jpg,0,3,22,68,8,101,3.8019801980198,0.616762547179999,74.3173913043478
4383247323.jpg,5,23,57,17,0,102,2.84313725490196,0.754459980491137,48.3050458715596
9214795039.jpg,8,65,27,1,0,101,2.20792079207921,0.588503724426079,31.8411214953271
8600750192.jpg,4,63,35,6,0,108,2.39814814814815,0.654814160906468,37.1842105263158
11439591215.jpg,6,70,25,0,0,101,2.18811881188119,0.523695928705365,31.1736111111111
4770169005.jpg,0,0,44,60,4,108,3.62962962962963,0.556903867483925,70.3147321428571
5962747.jpg,20,73,16,0,0,109,1.96330275229358,0.576172002106032,25.8181818181818
6128487555.jpg,3,70,34,1,0,108,2.30555555555556,0.53753214784685,34.9491150442478
3927444590.jpg,0,6,68,48,1,123,3.35772357723577,0.588553120307049,65.9772727272727
7384140824.jpg,0,0,20,64,23,107,4.02803738317757,0.636291494924962,81.0735294117647
372117089.jpg,0,0,57,50,0,107,3.46728971962617,0.501276803910374,67.0717391304348
5930701704.jpg,0,6,57,43,0,106,3.34905660377358,0.586230132451472,63.2219626168224
5128756378.jpg,0,0,11,81,16,108,4.0462962962963,0.500173040323575,80.1029411764706
9731493509.jpg,13,74,18,0,0,105,2.04761904761905,0.543863535997354,27.6597222222222
11307198154.jpg,0,0,21,72,7,100,3.86,0.512864799952486,80.8
6243772733.jpg,2,54,44,1,0,101,2.43564356435644,0.555262849183311,37.4696261682243
8509120510.jpg,0,4,91,33,0,128,3.2265625,0.489493451011019,62.25
9766865862.jpg,1,34,58,10,1,104,2.76923076923077,0.671627052526057,48.0872641509434
2897238920.jpg,1,56,43,6,0,106,2.50943396226415,0.620986665279237,40.2413043478261
4346999174.jpg,0,2,29,68,3,102,3.70588235294118,0.555587910790175,72.3738532110092
8756419280.jpg,0,7,66,28,3,104,3.25961538461538,0.623102047271884,61.6227678571429
5807318968.jpg,0,21,77,10,0,108,2.89814814814815,0.52844003921284,51.5487288135593
5176681750.jpg,0,3,48,54,2,107,3.51401869158878,0.588642281437874,67.1386554621849
8242906564.jpg,33,58,13,1,0,105,1.82857142857143,0.671638966334519,22.6460396039604
186520031.jpg,1,11,44,40,2,98,3.31632653061224,0.740533922394312,60.8298319327731
3026154930.jpg,0,10,72,24,1,107,3.14953271028037,0.579585706260149,56.61875
8968242975.jpg,16,71,23,1,0,111,2.08108108108108,0.619899333985111,27.6152173913043
4978032841.jpg,11,88,11,0,0,110,2.0,0.449260350337442,25.6800847457627
3364868711.jpg,16,73,13,1,0,103,1.99029126213592,0.568712781692267,26.5675675675676
8529490962.jpg,1,4,76,24,0,105,3.17142857142857,0.527277894493955,60.9927184466019
6008172185.jpg,0,10,58,38,3,109,3.31192660550459,0.676281331257795,63.186974789916
11031973684.jpg,1,0,35,72,3,111,3.68468468468468,0.571791156756667,71.4745762711864
3370673214.jpg,0,4,59,41,0,104,3.35576923076923,0.555960975629318,63.3581081081081
6870564661.jpg,0,5,52,44,2,103,3.41747572815534,0.61873165403042,66.7027027027027
411025625.jpg,0,2,62,78,2,144,3.55555555555556,0.55189156958981,71.8931034482759
5646738672.jpg,0,6,60,39,0,105,3.31428571428571,0.577032956569235,62.1383928571429
6107838272.jpg,1,35,68,8,0,112,2.74107142857143,0.596469126003533,48.5086206896552
3940847938.jpg,15,67,18,1,0,101,2.04950495049505,0.60623819780285,27.55
3308046325.jpg,4,25,70,11,1,111,2.81981981981982,0.690167281411453,49.8486842105263
1995190133.jpg,0,0,16,77,9,102,3.93137254901961,0.492715328040957,77.3692660550459
9262147694.jpg,0,9,87,10,0,106,3.00943396226415,0.425279359589344,55.2142857142857
3421464878.jpg,0,2,54,44,1,101,3.43564356435644,0.555262849183311,63.5940366972477
9913105155.jpg,0,1,36,64,6,107,3.70093457943925,0.586240875071248,72.4521739130435
3256723994.jpg,0,12,85,9,0,106,2.97169811320755,0.446308609219084,54.9933035714286
8165323576.jpg,28,64,12,0,0,104,1.84615384615385,0.603697840726373,22.2455752212389
3721179887.jpg,4,44,53,6,0,107,2.57009345794393,0.660362243825315,43.5878378378378
6191653562.jpg,0,1,30,72,3,106,3.72641509433962,0.526136300789146,74.8943965517241
3812865597.jpg,0,2,52,49,3,106,3.5,0.589592272353571,67.8102678571429
6095633645.jpg,5,59,40,5,0,109,2.41284403669725,0.655616887540276,38.125
3585744087.jpg,16,68,20,3,0,107,2.09345794392523,0.666343306049132,29.3550420168067
9684211981.jpg,0,0,17,88,5,110,3.89090909090909,0.435688941843877,75.7352941176471
5149825714.jpg,0,6,67,36,1,110,3.29090909090909,0.580184319738758,62.3274336283186
5013265495.jpg,0,1,38,67,1,107,3.63551401869159,0.521111355290732,74.2837837837838
4626914740.jpg,0,0,51,51,2,104,3.52884615384615,0.538908115251656,69.7991071428571
2646059323.jpg,0,6,47,53,3,109,3.48623853211009,0.64714013164307,67.4380530973451
1430765461.jpg,0,22,69,15,0,106,2.93396226415094,0.589896971222672,52.8571428571429
9657096738.jpg,2,9,67,21,0,99,3.08080808080808,0.617380372230659,58.2694174757282
3828155719.jpg,0,11,79,43,0,133,3.2406015037594,0.592252709420483,62.3111510791367
3388708914.jpg,0,1,44,51,6,102,3.6078431372549,0.615908935423586,69.325
5135958105.jpg,5,25,61,9,1,101,2.76237623762376,0.723166852828379,47.6995412844037
9329940580.jpg,0,24,59,18,1,102,2.96078431372549,0.673715405841618,50.95
2093280771.jpg,3,45,53,3,0,104,2.53846153846154,0.606166962854181,41.9415887850467
8406395791.jpg,0,2,50,54,2,108,3.51851851851852,0.571626331798371,69.0442477876106
523099326.jpg,1,8,34,50,9,102,3.56862745098039,0.802345619727813,67.0
7042014185.jpg,0,1,79,31,0,111,3.27027027027027,0.466046153507372,62.9108695652174
8644363471.jpg,0,4,47,84,4,139,3.63309352517986,0.591533071981295,75.3097826086957
5250708423.jpg,3,49,46,8,0,106,2.55660377358491,0.677251991918114,42.4133663366337
5399475116.jpg,0,1,41,63,1,106,3.60377358490566,0.528776580473741,72.671875
6843525285.jpg,0,2,51,74,2,129,3.58914728682171,0.553573661267958,71.5343511450382
6088929536.jpg,0,1,35,88,4,128,3.7421875,0.521144919920606,78.1732283464567
6699302891.jpg,0,0,20,77,13,110,3.93636363636364,0.546503023439813,81.7162162162162
4875993491.jpg,0,4,56,42,1,103,3.38834951456311,0.58129351549086,63.4426605504587
5706891854.jpg,0,3,51,49,1,104,3.46153846153846,0.573239422405291,66.2633928571429
7055216867.jpg,0,2,38,71,0,111,3.62162162162162,0.52317308198155,72.1206896551724
5492807512.jpg,0,7,65,35,0,107,3.26168224299065,0.571929019842775,63.0367647058824
7066508685.jpg,0,14,73,11,0,98,2.96938775510204,0.506739763884901,53.6788990825688
7914531096.jpg,0,0,25,74,5,104,3.80769230769231,0.503905582867573,76.6495535714286
6034305010.jpg,23,63,20,0,0,106,1.97169811320755,0.639308363926894,26.7075892857143
6093527262.jpg,0,1,21,72,8,102,3.85294117647059,0.552170493535534,74.795871559633
1360663704.jpg,0,0,24,81,5,110,3.82727272727273,0.485743370706337,77.224358974359
5552904756.jpg,0,2,43,62,3,110,3.6,0.577879705586241,70.9851694915254
9387665300.jpg,0,0,23,75,11,109,3.88990825688073,0.550074903002013,78.9330357142857
1410303503.jpg,0,4,45,53,2,104,3.50961538461538,0.607320908240659,68.9888392857143
10395523125.jpg,0,10,58,32,1,101,3.23762376237624,0.634799414799433,60.5069444444444
9878706283.jpg,0,25,65,13,1,104,2.90384615384615,0.631214436956219,49.1487068965517
3355209894.jpg,0,9,64,33,0,106,3.22641509433962,0.590125392130061,59.8260869565217
7388185182.jpg,0,2,52,46,1,101,3.45544554455446,0.557220826517594,68.0596330275229
9063924933.jpg,0,1,40,66,0,107,3.60747663551402,0.509476411693017,73.9358407079646
4050875089.jpg,0,1,39,59,2,101,3.61386138613861,0.547179989212014,68.3630434782609
5645276165.jpg,0,6,50,46,3,105,3.43809523809524,0.649316349410456,63.5810810810811
10218118033.jpg,0,1,25,76,5,107,3.79439252336449,0.527334302993257,75.6659663865546
6873503299.jpg,2,42,64,7,0,115,2.66086956521739,0.619662564113602,44.7179487179487
5906517609.jpg,0,0,44,64,0,108,3.59259259259259,0.493642517690404,69.0986842105263
8045159223.jpg,0,33,60,12,0,105,2.8,0.62634470725607,47.2995689655172
7991449337.jpg,0,0,21,65,13,99,3.91919191919192,0.583388547612185,80.8509174311927
6033104227.jpg,0,1,26,72,6,105,3.79047619047619,0.549391938265845,74.3738938053097
6007032209.jpg,19,82,11,1,0,113,1.94690265486726,0.548385747388932,25.4033613445378
5266542779.jpg,0,5,58,37,0,100,3.32,0.566399223876658,64.5022935779816
10567114974.jpg,0,8,53,47,1,109,3.37614678899083,0.635216364796543,64.8478260869565
8504503946.jpg,0,1,53,47,0,101,3.45544554455446,0.520091385724615,67.5689655172414
8128148667.jpg,0,2,33,58,6,99,3.68686868686869,0.616879319499211,73.45
7863241080.jpg,1,14,59,29,1,104,3.14423076923077,0.688579080507115,58.896017699115
66839471.jpg,0,4,53,43,0,100,3.39,0.566666666666667,63.7954545454545
3992677101.jpg,22,73,6,0,0,101,1.84158415841584,0.504632009831456,21.6596638655462
4411284601.jpg,0,6,57,40,0,103,3.33009708737864,0.583907552355093,62.6282051282051
8035433785.jpg,0,0,30,68,3,101,3.73267326732673,0.507761540664728,74.35
6890379430.jpg,0,8,65,39,1,113,3.29203539823009,0.607709633571641,60.3012820512821
6227646726.jpg,0,4,61,40,0,105,3.34285714285714,0.551720585437597,64.027027027027
6733542819.jpg,1,5,59,38,0,103,3.30097087378641,0.607711093903304,60.0758928571429
4960025889.jpg,1,25,77,6,0,109,2.80733944954128,0.535361840602941,48.7905405405405
8914830252.jpg,0,4,45,58,1,108,3.51851851851852,0.587748459794076,67.9407894736842
8595112756.jpg,0,0,23,75,4,102,3.81372549019608,0.48195953482134,77.5862831858407
8090361774.jpg,10,53,36,2,0,101,2.2970297029703,0.671484243380968,35.9861111111111
7188151253.jpg,3,57,41,3,0,104,2.42307692307692,0.602459484877279,38.3347457627119
3258938541.jpg,0,0,39,62,1,102,3.62745098039216,0.505838557336368,73.875
6013203590.jpg,6,73,28,0,0,107,2.20560747663551,0.527334302993257,31.5472972972973
412289790.jpg,36,66,5,0,0,107,1.71028037383178,0.549602700317316,17.4263392857143
6967399980.jpg,0,2,34,62,7,105,3.7047619047619,0.618991262579839,76.0509708737864
3871801313.jpg,0,20,83,6,0,109,2.87155963302752,0.473382576295965,50.6398305084746
7413044200.jpg,0,0,11,87,9,107,3.98130841121495,0.433966097519735,80.2995689655172
10586872235.jpg,2,43,60,1,0,106,2.56603773584906,0.552377854190896,41.6388888888889
9602714230.jpg,0,7,61,37,0,105,3.28571428571429,0.583660295599538,60.6081081081081
9220351854.jpg,0,4,65,37,1,107,3.32710280373832,0.562603465278173,60.6911764705882
6264359892.jpg,0,2,42,61,7,112,3.65178571428571,0.625434212102243,72.6410256410256
8300309247.jpg,2,59,41,9,0,111,2.51351351351351,0.672375231614351,41.6760869565217
8617517082.jpg,0,1,33,70,5,109,3.72477064220183,0.558960007067151,73.0826271186441
4493244545.jpg,0,1,28,75,4,108,3.75925925925926,0.527210439999348,72.2689075630252
1979184408.jpg,0,19,71,13,0,103,2.94174757281553,0.557044770940619,53.5200892857143
411787882.jpg,0,0,31,66,7,104,3.76923076923077,0.561391634768236,75.4652173913043
5891409099.jpg,0,2,60,42,1,105,3.4,0.547722557505166,66.4054054054054
9372136957.jpg,0,4,54,49,4,111,3.47747747747748,0.630250265541711,67.55
1252945239.jpg,45,55,6,0,0,106,1.63207547169811,0.590810124975516,15.6584821428571
8272075374.jpg,1,9,55,40,0,105,3.27619047619048,0.657723903017621,62.9906542056075
2322154086.jpg,0,13,77,11,0,101,2.98019801980198,0.489493575438983,54.9785714285714
2508139577.jpg,18,47,40,2,0,107,2.24299065420561,0.750359932441571,32.95
7452954268.jpg,0,1,33,75,3,112,3.71428571428571,0.527249730196496,72.0769230769231
3361988100.jpg,0,3,48,57,0,108,3.5,0.555347832401704,69.578125
487860600.jpg,50,62,0,0,0,112,1.55357142857143,0.499356084729624,15.8220338983051
8671346109.jpg,0,6,75,23,0,104,3.16346153846154,0.504553574148434,59.4866071428571
122346209.jpg,16,53,29,7,0,105,2.25714285714286,0.796972292595442,34.20625
6963387147.jpg,0,20,63,18,0,101,2.98019801980198,0.616120086018983,56.171875
3741472599.jpg,0,6,67,36,0,109,3.27522935779817,0.558960007067151,64.25
6766818267.jpg,2,37,55,13,0,107,2.73831775700935,0.691408851523274,48.2121848739496
4840518597.jpg,0,15,59,26,1,101,3.12871287128713,0.658230451082805,56.1766055045872
4423467099.jpg,0,19,64,22,0,105,3.02857142857143,0.627221327289334,56.1067961165049
8997198808.jpg,0,0,29,74,2,105,3.74285714285714,0.480956007675007,73.7434782608696
8504046996.jpg,2,41,55,9,0,107,2.66355140186916,0.657954595463405,45.6285714285714
11293946974.jpg,0,1,29,70,1,101,3.7029702970297,0.500890296481087,75.9800884955752
5907004909.jpg,42,55,7,0,0,104,1.66346153846154,0.601140936628686,17.5
5494859211.jpg,5,80,15,1,0,101,2.11881188118812,0.475123746257147,29.6415094339623
3359889192.jpg,0,2,44,54,0,100,3.52,0.54085603678359,69.0435779816514
7297786732.jpg,0,2,55,53,0,110,3.46363636363636,0.536336070311266,66.777027027027
8702541866.jpg,0,1,46,55,2,104,3.55769230769231,0.554363504117592,72.5808823529412
6603102821.jpg,0,1,44,59,1,105,3.57142857142857,0.534522483824849,68.0405405405405
9315620500.jpg,0,4,64,70,0,138,3.47826086956522,0.556545540589091,69.0342465753425
6890378940.jpg,0,1,33,62,5,101,3.7029702970297,0.575231335298166,75.775
5948782020.jpg,20,70,14,2,0,106,1.9811320754717,0.632171346203991,25.8193277310924
11521791886.jpg,0,23,64,17,0,104,2.94230769230769,0.620474655090888,51.3839285714286
5936466945.jpg,0,19,78,13,0,110,2.94545454545455,0.539050535262052,52.1351351351351
4740901654.jpg,0,27,90,16,1,134,2.93283582089552,0.590625527890505,53.5625
8556290824.jpg,0,5,51,42,1,99,3.39393939393939,0.603022689155527,67.5606796116505
6860404399.jpg,1,50,54,3,0,108,2.5462962962963,0.570034582641014,41.5625
35002160.jpg,0,7,38,57,4,106,3.54716981132075,0.677981253732946,68.468220338983
9245144961.jpg,0,7,70,27,0,104,3.19230769230769,0.541069115641818,59.7721238938053
6171205916.jpg,0,10,74,16,0,100,3.06,0.508910501944987,56.7064220183486
6293184375.jpg,0,0,49,57,2,108,3.56481481481481,0.534302727522781,68.6638655462185
11242015725.jpg,0,4,56,41,0,101,3.36633663366337,0.560763270502406,63.7152777777778
3225818665.jpg,51,53,3,0,0,107,1.55140186915888,0.553439414962658,13.2571428571429
5935217683.jpg,0,7,56,39,0,102,3.31372549019608,0.596697049969938,60.6482300884956
7903635044.jpg,0,16,67,21,0,104,3.04807692307692,0.597402267951459,56.1946902654867
7951947544.jpg,0,24,63,11,0,98,2.86734693877551,0.58570171328868,48.7905405405405
6252195920.jpg,0,3,25,70,8,106,3.78301886792453,0.617286180156368,71.7542372881356
8329938246.jpg,0,0,54,48,2,104,3.5,0.539687072220866,66.3310810810811
8403125101.jpg,0,3,50,52,0,105,3.46666666666667,0.55585462035892,67.0
8686047954.jpg,0,0,26,70,6,102,3.80392156862745,0.527261103264158,77.0178571428571
7845980046.jpg,0,0,24,71,4,99,3.7979797979798,0.494454925202593,75.7798165137615
8442858810.jpg,2,20,61,21,0,104,2.97115384615385,0.689121162134474,53.078125
5938961229.jpg,0,4,80,26,0,110,3.2,0.484626026252306,59.5602678571429
6160253188.jpg,12,72,23,1,0,108,2.12037037037037,0.591490949877323,29.0065789473684
11033459414.jpg,0,7,50,43,3,103,3.40776699029126,0.663279038134847,63.5565217391304
8120735257.jpg,0,3,36,69,0,108,3.61111111111111,0.544013010656216,72.7594339622642
5027882580.jpg,0,0,30,59,18,107,3.88785046728972,0.663425968111645,78.6513157894737
2422029745.jpg,8,82,10,1,0,101,2.03960396039604,0.467349806444978,27.0486111111111
9732569997.jpg,0,0,35,70,4,109,3.71559633027523,0.528655582048325,73.7302631578947
3708879448.jpg,2,13,41,41,4,101,3.31683168316832,0.823780226386952,59.5391304347826
4730475136.jpg,3,23,67,13,1,107,2.86915887850467,0.68795721879841,50.5
5430352868.jpg,0,2,40,58,3,103,3.60194174757282,0.583091924701258,71.0884955752212
6835007518.jpg,2,68,37,1,0,108,2.34259259259259,0.532355671933666,35.0794392523364
7108939139.jpg,0,0,12,86,11,109,3.99082568807339,0.461387056201525,81.1228813559322
6521723915.jpg,0,2,37,55,3,97,3.60824742268041,0.587308497705987,72.7522935779816
8653385211.jpg,0,2,34,60,2,98,3.63265306122449,0.563270184789685,74.7785714285714
6411944553.jpg,0,16,67,21,0,104,3.04807692307692,0.597402267951459,56.9977876106195
418145002.jpg,0,10,64,29,0,103,3.18446601941748,0.589908148641803,58.6714285714286
8390342452.jpg,0,14,68,17,0,99,3.03030303030303,0.561603852219212,57.2281553398058
9519070785.jpg,0,1,42,62,2,107,3.60747663551402,0.545254127107898,69.2878151260504
6976437867.jpg,0,1,41,67,2,111,3.63063063063063,0.538143744364542,71.614406779661
5238246589.jpg,0,2,35,61,3,101,3.64356435643564,0.575919411304074,73.375
10316734944.jpg,0,2,50,49,0,101,3.46534653465347,0.539710226615053,67.3055555555556
299519765.jpg,0,1,31,71,3,106,3.71698113207547,0.530134160578282,74.95
7238571992.jpg,0,2,35,61,0,98,3.60204081632653,0.53225441398212,72.9271844660194
8256731117.jpg,0,26,71,10,0,107,2.85046728971963,0.563073411175464,48.1118421052632
7319806894.jpg,0,7,53,44,1,105,3.37142857142857,0.624147770612408,63.4038461538462
5192516842.jpg,1,31,60,11,0,103,2.78640776699029,0.636326550722794,47.5796460176991
3347228837.jpg,0,5,40,46,4,95,3.51578947368421,0.66625593917335,70.7714285714286
7169475537.jpg,0,1,14,80,6,101,3.9009900990099,0.479686366182102,82.618932038835
5354068609.jpg,0,8,55,33,1,97,3.27835051546392,0.624871120732726,62.9142857142857
2848340403.jpg,1,23,80,9,1,114,2.87719298245614,0.582037174210297,50.7079831932773
8642423630.jpg,1,5,49,52,3,110,3.46363636363636,0.67289969163006,66.4210526315789
5477401446.jpg,0,20,64,20,0,104,3.0,0.623176952849756,53.2978260869565
5560114332.jpg,6,41,40,12,3,102,2.65686274509804,0.873086003262783,44.65
6151722057.jpg,0,1,35,62,4,102,3.67647058823529,0.565716311123285,72.2027027027027
6189434531.jpg,1,24,102,14,0,141,2.91489361702128,0.541022335188902,52.2280405405405
7676074992.jpg,0,9,71,23,0,103,3.13592233009709,0.543202986096654,56.8297413793103
6994313445.jpg,0,0,17,80,8,105,3.91428571428571,0.482666585716303,79.0464601769911
5631740117.jpg,0,1,16,73,8,98,3.89795918367347,0.527389914606065,77.2212389380531
4040905906.jpg,0,0,48,60,1,109,3.56880733944954,0.515805240252132,67.1375
3552766173.jpg,0,0,30,66,5,101,3.75247524752475,0.536766999620122,72.3086956521739
5443343893.jpg,0,7,61,33,0,101,3.25742574257426,0.577121570321794,59.265625
4885242381.jpg,2,6,48,43,2,101,3.36633663366337,0.717255495304535,64.1013513513514
8108582186.jpg,0,5,55,43,2,105,3.4,0.61394061351492,65.6973684210526
3383452055.jpg,0,6,69,34,2,111,3.28828828828829,0.593715380041609,63.364406779661
9686337427.jpg,11,67,23,1,0,102,2.13725490196078,0.597672311394309,29.9142857142857
6248527465.jpg,0,1,33,60,3,97,3.6701030927835,0.553805950607101,75.6391509433962
145089144.jpg,35,69,2,0,0,106,1.68867924528302,0.504516884368361,19.425
9428417271.jpg,0,4,42,55,1,102,3.51960784313725,0.592534281196727,69.325
6834514891.jpg,8,78,19,1,0,106,2.12264150943396,0.529201198369576,28.8081896551724
9164359125.jpg,0,4,64,34,0,102,3.29411764705882,0.537471809882315,63.6388888888889
9294636383.jpg,10,61,24,0,0,95,2.14736842105263,0.582883898746305,29.6785714285714
4607436163.jpg,0,3,51,55,0,109,3.47706422018349,0.554382042946274,67.9088983050847
8130469512.jpg,0,14,69,20,1,104,3.07692307692308,0.602459484877279,56.9719827586207
4213334951.jpg,8,69,26,1,0,104,2.19230769230769,0.575839161014367,32.8214285714286
2588767665.jpg,0,7,61,36,0,104,3.27884615384615,0.582207562647962,61.0572033898305
5158556376.jpg,0,3,52,49,2,106,3.47169811320755,0.588906123488388,67.445945945946
11498400544.jpg,1,25,101,13,0,140,2.9,0.540450118822498,50.6695205479452
7312752876.jpg,1,25,62,19,1,108,2.94444444444444,0.694885633477702,50.5693277310924
9299238943.jpg,1,31,59,18,0,109,2.86238532110092,0.686751476804853,49.7373949579832
4040650709.jpg,1,39,58,7,0,105,2.67619047619048,0.612297660381309,45.0
5251948512.jpg,0,2,72,80,1,155,3.51612903225806,0.538815906080325,71.3860759493671
4743830608.jpg,0,3,67,55,0,125,3.416,0.541562851920851,68.452
2693433475.jpg,0,10,70,22,1,103,3.13592233009709,0.578173996629761,58.8230088495575
6960806686.jpg,0,2,71,32,0,105,3.28571428571429,0.494474968532781,60.9598214285714
7292878318.jpg,0,4,66,33,0,103,3.28155339805825,0.531691266161905,61.1381578947368
352331466.jpg,4,65,53,6,0,128,2.4765625,0.639449120075518,38.3125
5038604558.jpg,0,0,16,77,12,105,3.96190476190476,0.517460692000434,78.222972972973
3115128591.jpg,3,18,65,14,0,100,2.9,0.659047368816107,49.0398230088496
6066096952.jpg,1,11,74,23,0,109,3.09174311926605,0.585966823793358,56.2894736842105
8499771607.jpg,0,5,47,43,1,96,3.41666666666667,0.609860495983634,66.0480769230769
5490633123.jpg,0,5,81,24,0,110,3.17272727272727,0.485743370706337,58.3157894736842
3304800536.jpg,9,64,34,1,0,108,2.25,0.613325545121892,33.8601694915254
5069309990.jpg,20,74,10,0,0,104,1.90384615384615,0.530967806041971,22.7828947368421
5124180488.jpg,0,0,13,91,3,107,3.90654205607477,0.376996828983557,82.7567567567568
134343714.jpg,12,40,35,14,1,102,2.52941176470588,0.908767878225174,40.031512605042
5533236075.jpg,0,3,50,51,3,107,3.50467289719626,0.604602345155841,70.225
6702441233.jpg,0,0,18,81,6,105,3.88571428571429,0.466457305208545,77.7608695652174
10475435053.jpg,0,15,64,25,3,107,3.14953271028037,0.684101646394152,57.8487394957983
3228957282.jpg,0,1,61,63,0,125,3.496,0.517811773000638,69.5282258064516
7751952772.jpg,0,1,46,66,0,113,3.57522123893805,0.514179473504584,73.3918918918919
2287163032.jpg,2,8,59,30,1,100,3.2,0.681649810860727,60.475
6994871976.jpg,0,2,63,34,2,101,3.35643564356436,0.558285919862602,64.9
9685106937.jpg,4,42,59,2,0,107,2.55140186915888,0.602410955759534,42.175
4843346384.jpg,0,14,60,32,0,106,3.16981132075472,0.639519136512629,58.9579831932773
4622287144.jpg,0,3,25,71,3,102,3.72549019607843,0.565630512031092,74.425
8316898244.jpg,0,3,41,65,1,110,3.58181818181818,0.564741041277403,68.30625
128715765.jpg,0,18,54,29,0,101,3.10891089108911,0.676771602522002,56.9772727272727
8724954192.jpg,4,38,54,10,0,106,2.66037735849057,0.702197807605727,43.6483050847458
3021647597.jpg,0,3,48,51,0,102,3.47058823529412,0.55768052803139,66.8457943925234
4794298678.jpg,0,5,59,43,0,107,3.35514018691589,0.570539903993596,65.6383495145631
3518866605.jpg,0,9,91,25,1,126,3.14285714285714,0.532380100518954,60.7621951219512
10604417276.jpg,0,0,27,67,7,101,3.8019801980198,0.548083971307281,77.3692660550459
4777018149.jpg,0,1,41,57,2,101,3.59405940594059,0.550966747123312,69.4672897196262
6609931137.jpg,0,4,62,50,1,117,3.41025641025641,0.574664012089195,67.2115384615385
4719295519.jpg,0,31,68,8,0,107,2.78504672897196,0.56681895188049,49.3108108108108
7840986296.jpg,0,3,39,61,2,105,3.59047619047619,0.583346415342582,69.9413043478261
1306193020.jpg,7,69,30,2,0,108,2.25,0.597893498471106,33.573275862069
4674618399.jpg,0,17,59,32,0,108,3.13888888888889,0.662173330970994,56.4427966101695
4574265376.jpg,2,53,46,1,0,102,2.45098039215686,0.556286324530138,40.1875
11316105544.jpg,0,0,20,85,4,109,3.85321100917431,0.447745134047106,77.8625
9763431522.jpg,0,0,13,83,6,102,3.93137254901961,0.428208423425378,82.0721153846154
7809493264.jpg,0,0,22,71,10,103,3.88349514563107,0.547739935316853,78.4910714285714
7946918290.jpg,5,70,27,2,0,104,2.25,0.570300550978694,32.9976635514019
8706343716.jpg,0,3,83,23,0,109,3.18348623853211,0.454710685688426,60.5677966101695
3654348116.jpg,0,11,80,20,0,111,3.08108108108108,0.524580094155578,56.2171052631579
8669875850.jpg,0,0,13,71,25,109,4.11009174311927,0.582768767136427,82.3114406779661
3194036363.jpg,0,2,58,41,0,101,3.38613861386139,0.528588630783958,67.15
6127748837.jpg,0,0,53,54,1,108,3.51851851851852,0.520270984055541,67.9491150442478
5426100555.jpg,1,18,57,19,3,98,3.05102040816327,0.737402084775165,55.357476635514
6899517653.jpg,0,1,40,65,3,109,3.64220183486239,0.553154853742444,70.0847826086956
1036840624.jpg,8,68,20,0,0,96,2.125,0.528154682286404,28.3382352941176
8930021210.jpg,1,13,59,30,0,103,3.14563106796116,0.662848384022915,55.5089285714286
7390518132.jpg,0,2,67,68,2,139,3.50359712230216,0.556569470635816,70.7065217391304
461078499.jpg,54,55,1,0,0,110,1.51818181818182,0.51991209881294,13.3050847457627
3132669524.jpg,15,79,19,0,0,113,2.0353982300885,0.549824704854436,28.5924369747899
3905518312.jpg,2,47,53,1,0,103,2.51456310679612,0.557727842651489,39.3035714285714
5963776272.jpg,7,85,11,3,0,106,2.09433962264151,0.526050909844691,29.8403361344538
5137508075.jpg,0,10,57,33,1,101,3.24752475247525,0.638841773744632,60.775
10582113466.jpg,0,12,68,24,0,104,3.11538461538462,0.579716909616233,58.1607142857143
2844802224.jpg,2,21,55,27,0,105,3.01904761904762,0.733549751615552,52.5067567567568
306264588.jpg,30,74,6,0,0,110,1.78181818181818,0.531258125581778,20.2013274336283
6920118996.jpg,0,1,60,41,0,102,3.3921568627451,0.510423290560389,64.9375
5606693622.jpg,1,11,58,44,0,114,3.2719298245614,0.66897210438684,61.5231092436975
4005164524.jpg,1,59,73,5,0,138,2.59420289855072,0.574871374498517,42.7620689655172
3734652007.jpg,1,20,66,19,0,106,2.97169811320755,0.639308363926894,54.1844660194175
3256967457.jpg,0,26,66,11,0,103,2.85436893203884,0.584233484589436,51.7411504424779
9518037590.jpg,0,0,22,79,4,105,3.82857142857143,0.469392874178625,76.3168103448276
4254945684.jpg,29,68,10,0,0,107,1.82242990654206,0.579737808534454,22.4915966386555
7940282852.jpg,0,38,56,6,0,100,2.68,0.583960701597377,43.4285714285714
3586827526.jpg,0,0,43,58,1,102,3.58823529411765,0.514212676586054,70.225
6707835355.jpg,0,2,25,77,1,105,3.73333333333333,0.505102172959299,74.7102803738318
8439178228.jpg,2,32,61,10,0,105,2.75238095238095,0.647197395594628,46.7569444444444
8208757707.jpg,0,42,63,6,0,111,2.67567567567568,0.574648701574388,45.5926724137931
8353276755.jpg,0,2,43,61,1,107,3.57009345794393,0.551364508625548,71.125
7100857351.jpg,0,2,30,65,4,101,3.7029702970297,0.575231335298166,77.1957547169811
8800590382.jpg,0,15,98,25,0,138,3.07246376811594,0.535426443855604,57.2808219178082
4202847613.jpg,1,40,53,6,0,100,2.64,0.611671001553461,44.0665137614679
5959274849.jpg,2,33,56,18,0,109,2.8256880733945,0.718074027665874,47.26875
6668846319.jpg,0,6,71,32,0,109,3.23853211009174,0.542611698158005,61.6964285714286
6090586494.jpg,0,0,47,64,0,111,3.57657657657658,0.496342065873372,70.3846153846154
7736601364.jpg,0,2,11,95,6,114,3.92105263157895,0.463628185673106,83.7209821428571
6578628541.jpg,0,17,64,27,0,108,3.09259259259259,0.634477296634495,55.7689075630252
6789846783.jpg,56,50,6,0,0,112,1.55357142857143,0.597883439697578,13.4121621621622
5482786130.jpg,0,0,31,69,8,108,3.78703703703704,0.564543085877154,76.5413043478261
5377492041.jpg,0,10,68,27,1,106,3.17924528301887,0.598365548590026,58.6113445378151
7856451374.jpg,0,1,47,51,2,101,3.53465346534653,0.557931114666382,68.875
6415648509.jpg,1,3,55,48,2,109,3.43119266055046,0.629034717246345,68.0951327433628
6167876275.jpg,0,1,52,46,2,101,3.48514851485149,0.558817705269592,64.8478260869565
8216954885.jpg,0,0,27,81,3,111,3.78378378378378,0.474924020821042,76.2987288135593
774152136.jpg,0,18,69,12,0,99,2.93939393939394,0.54991987947377,54.7836538461538
9225734576.jpg,0,2,55,53,0,110,3.46363636363636,0.536336070311266,67.5110619469027
6811037194.jpg,8,48,44,5,0,105,2.43809523809524,0.70606996716671,38.1621621621622
5692807668.jpg,2,51,50,2,0,105,2.4952380952381,0.573850180189942,38.0891304347826
8413515646.jpg,0,0,10,73,17,100,4.07,0.517472489875334,82.5833333333333
6978738588.jpg,0,0,34,67,4,105,3.71428571428571,0.531946456861058,72.7115384615385
6113689999.jpg,0,0,26,72,4,102,3.7843137254902,0.500048531909845,74.0921052631579
7993315454.jpg,0,12,68,27,0,107,3.14018691588785,0.589988777169262,58.9
8030242803.jpg,1,13,66,26,0,106,3.10377358490566,0.631389175631893,58.9086538461538
7866144530.jpg,0,0,25,75,3,103,3.78640776699029,0.477954904692351,75.9311926605505
2366273919.jpg,12,63,28,1,0,104,2.17307692307692,0.630030168676761,29.5066964285714
4056860839.jpg,0,0,25,76,6,107,3.82242990654206,0.510513690836126,77.4021739130435
7276523780.jpg,0,1,29,74,1,105,3.71428571428571,0.494474968532781,74.627358490566
11170786154.jpg,0,3,48,55,2,108,3.51851851851852,0.587748459794076,67.6932773109244
6923520196.jpg,1,78,26,1,0,106,2.25471698113208,0.479311425846485,32.35
8321480608.jpg,1,25,76,13,0,115,2.87826086956522,0.594533962952917,51.478813559322
3503300231.jpg,0,0,17,83,8,108,3.91666666666667,0.476062510620918,76.41875
9572676975.jpg,0,3,49,48,5,105,3.52380952380952,0.636928297124296,69.2098214285714
10022757465.jpg,0,3,32,66,4,105,3.67619047619048,0.596387169276516,71.0154867256637
5905146921.jpg,0,15,73,12,0,100,2.97,0.521361853052351,53.5275229357798
2129246782.jpg,0,4,58,40,1,103,3.36893203883495,0.577185382632161,64.7429245283019
5204782737.jpg,0,30,69,3,0,102,2.73529411764706,0.505934496371339,48.2367256637168
8185829074.jpg,0,1,47,53,6,107,3.5981308411215,0.612138427495947,73.4247787610619
8309215514.jpg,26,60,15,0,0,101,1.89108910891089,0.630888105752675,23.8042452830189
3985258920.jpg,2,18,57,29,0,106,3.06603773584906,0.720698971892047,52.3877118644068
4682743182.jpg,6,55,37,3,0,101,2.36633663366337,0.643782141368145,35.3357142857143
10407720764.jpg,1,59,40,3,0,103,2.43689320388349,0.5717174489413,38.6261682242991
139253033.jpg,9,71,25,1,0,106,2.16981132075472,0.576883220223454,30.90625
5727031782.jpg,0,5,49,51,0,105,3.43809523809524,0.587101903155359,67.9611650485437
5172565267.jpg,0,49,49,7,0,105,2.6,0.61394061351492,41.6858974358974
4671787703.jpg,0,4,63,38,0,105,3.32380952380952,0.545880342186223,63.4642857142857
8375881781.jpg,0,22,60,27,0,109,3.04587155963303,0.671997038972167,53.6625
5277615188.jpg,0,0,16,82,4,102,3.88235294117647,0.429001088116482,78.9858490566038
4782504809.jpg,0,6,39,58,0,103,3.50485436893204,0.608337277576797,69.6714285714286
8288312901.jpg,0,2,38,61,3,104,3.625,0.577700496864656,71.7763157894737
8034781018.jpg,0,0,14,84,4,102,3.90196078431373,0.410500875448437,79.2614678899083
8549362115.jpg,0,11,60,36,0,107,3.23364485981308,0.623130248541874,59.9802631578947
69161613.jpg,0,3,32,65,4,104,3.67307692307692,0.598417130425389,71.74375
6311708784.jpg,0,10,73,27,1,111,3.17117117117117,0.585799746638169,57.7794117647059
2512779647.jpg,0,19,63,29,0,111,3.09009009009009,0.654349775100159,57.6120689655172
8033033726.jpg,0,0,17,84,5,106,3.88679245283019,0.443379977144857,79.3378378378378
8892359151.jpg,1,14,72,19,0,106,3.02830188679245,0.592935348114805,55.1824324324324
5120849681.jpg,7,56,36,4,0,103,2.35922330097087,0.669421303082274,35.9642857142857
6229984844.jpg,0,7,80,20,0,107,3.1214953271028,0.489710741996757,59.2948113207547
4347675881.jpg,1,31,60,21,0,113,2.89380530973451,0.699015019489249,50.0769230769231
5838518725.jpg,0,4,52,47,2,105,3.44761904761905,0.604167456106596,65.8108108108108
8488084256.jpg,0,4,58,58,1,121,3.46280991735537,0.577946397659414,68.44375
10140071304.jpg,0,7,63,31,2,103,3.27184466019417,0.613478905741538,62.5576923076923
5950379360.jpg,0,3,40,59,8,110,3.65454545454545,0.655762930372485,71.7347826086957
3505627590.jpg,2,56,44,4,0,106,2.47169811320755,0.604862001889472,40.703125
4644879921.jpg,0,12,70,21,1,104,3.10576923076923,0.589853844506429,57.2767857142857
3434261812.jpg,0,30,68,7,0,105,2.78095238095238,0.554369919210997,47.3325892857143
3910222592.jpg,0,3,37,68,2,110,3.62727272727273,0.572441910984171,67.9705882352941
5798775388.jpg,2,28,68,8,0,106,2.77358490566038,0.606049170846951,49.8370535714286
3289145933.jpg,0,18,62,25,0,105,3.06666666666667,0.639511031159244,58.3495145631068
7084961757.jpg,0,5,57,40,2,104,3.375,0.610387430681514,64.2021739130435
6965747606.jpg,0,1,11,89,4,105,3.91428571428571,0.418658244006642,79.4864864864865
2304159288.jpg,2,23,90,25,0,140,2.98571428571429,0.634564534145968,54.8741610738255
6082438802.jpg,1,1,38,65,0,105,3.59047619047619,0.566623570867177,69.8986486486486
11018079835.jpg,0,0,22,86,2,110,3.81818181818182,0.432229513059863,76.6602564102564
6282202152.jpg,0,0,37,66,2,105,3.66666666666667,0.512660231362364,72.4762931034483
8691629871.jpg,0,36,59,12,0,107,2.77570093457944,0.634070575426553,49.2867647058824
2590631506.jpg,0,1,21,78,10,110,3.88181818181818,0.554081075474067,78.75625
1130601148.jpg,0,0,43,59,5,107,3.64485981308411,0.570539903993596,72.3804347826087
10227210045.jpg,0,5,48,48,2,103,3.45631067961165,0.622718565915461,70.4245283018868
2702264162.jpg,0,7,74,28,1,110,3.20909090909091,0.560069696604103,60.5128205128205
5681342957.jpg,0,1,32,66,3,102,3.69607843137255,0.541161488064193,75.025
9081876401.jpg,0,1,43,60,3,107,3.60747663551402,0.562289949809258,70.813025210084
6138545533.jpg,0,21,75,13,1,110,2.94545454545455,0.587895697488881,53.3205128205128
4281731487.jpg,0,1,22,65,11,99,3.86868686868687,0.600109932896051,78.625
8776151757.jpg,0,3,65,37,2,107,3.35514018691589,0.570539903993596,64.7702702702703
9525267533.jpg,1,13,78,14,0,106,2.99056603773585,0.543275480744748,54.6986607142857
3856900502.jpg,0,4,44,49,4,101,3.52475247524752,0.641779703729256,70.8076923076923
7841765362.jpg,1,1,68,64,0,134,3.45522388059702,0.556785506166025,70.1635338345865
8246479044.jpg,0,1,68,37,1,107,3.35514018691589,0.518567265129718,63.9152173913043
1101948952.jpg,0,0,26,73,1,100,3.75,0.457816513022367,75.1743119266055
3315383233.jpg,27,63,10,0,0,100,1.83,0.586979943903925,21.2905405405405
7660271516.jpg,0,4,45,52,3,104,3.51923076923077,0.62287727649059,67.426724137931
9795395745.jpg,0,13,54,34,1,102,3.22549019607843,0.673499252024224,60.1378504672897
7111226249.jpg,0,0,52,60,1,113,3.54867256637168,0.517396477610979,67.3525641025641
8697364440.jpg,0,2,61,45,0,108,3.39814814814815,0.52844003921284,66.2763157894737
7325916584.jpg,0,2,35,71,1,109,3.65137614678899,0.533613585898434,75.8668224299065
11476172786.jpg,0,1,36,57,7,101,3.69306930693069,0.612251161818836,72.625
5248353672.jpg,2,55,42,4,0,103,2.46601941747573,0.607397759985128,40.3224299065421
9304089120.jpg,0,0,25,71,6,102,3.81372549019608,0.521429720673115,75.5446428571429
6192537618.jpg,0,1,60,70,1,132,3.53787878787879,0.530091494771472,71.912213740458
4782546865.jpg,0,2,55,55,1,113,3.48672566371681,0.55283432431341,67.0693277310924
3673357278.jpg,0,1,51,51,2,105,3.51428571428571,0.556677743304068,67.5110619469027
6238087656.jpg,0,4,57,35,1,97,3.34020618556701,0.575300608706446,66.4551886792453
6656239161.jpg,0,39,53,4,0,96,2.63541666666667,0.564190928240407,43.5857142857143
3487701269.jpg,0,6,45,52,3,106,3.49056603773585,0.650937536596151,69.5631067961165
4509028861.jpg,0,11,89,8,0,108,2.97222222222222,0.420465548242144,54.0044247787611
6190643783.jpg,0,0,31,76,3,110,3.74545454545455,0.49652671863516,71.60625
6342206102.jpg,1,6,75,43,0,125,3.28,0.590243252205558,64.4512195121951
5495773051.jpg,0,10,65,31,0,106,3.19811320754717,0.592328919576578,62.5803571428571
4742025728.jpg,0,7,64,39,0,110,3.29090909090909,0.580184319738758,62.359375
8260840073.jpg,2,20,76,9,0,107,2.85981308411215,0.573775942905748,49.5294117647059
8560160557.jpg,0,15,65,28,0,108,3.12037037037037,0.622289901377863,57.44375
8420816712.jpg,2,48,58,6,0,114,2.59649122807018,0.620009966314617,42.3922413793103
6372460147.jpg,0,7,41,59,2,109,3.51376146788991,0.64714013164307,65.8214285714286
7937116986.jpg,0,3,38,59,1,101,3.57425742574257,0.57177853498475,72.0711009174312
3296835726.jpg,0,1,61,48,0,110,3.42727272727273,0.51507710136473,66.0337837837838
8665123695.jpg,0,5,72,40,3,120,3.34166666666667,0.601061153131627,64.9724576271186
7223815722.jpg,0,4,47,56,0,107,3.48598130841122,0.572391309305167,69.2834821428571
3365471102.jpg,5,65,34,1,0,105,2.2952380952381,0.570489154548862,33.1081081081081
6093133362.jpg,2,31,45,26,1,105,2.93333333333333,0.811772356621214,51.9935344827586
5358352176.jpg,2,48,50,2,0,102,2.50980392156863,0.575835132469745,40.6605504587156
9314256771.jpg,0,6,42,58,1,107,3.50467289719626,0.620009613067607,69.2297297297297
5573505825.jpg,0,0,36,66,4,106,3.69811320754717,0.537539567903605,74.2888349514563
8514709398.jpg,1,46,55,3,0,105,2.57142857142857,0.569364403678193,40.6148648648649
6745774611.jpg,3,61,43,1,0,108,2.38888888888889,0.560929357894812,36.2
4851762296.jpg,1,12,66,19,0,98,3.05102040816327,0.598493796393481,51.5951327433628
494015270.jpg,1,23,59,17,0,100,2.92,0.661800421562119,50.954128440367
6344902938.jpg,0,1,22,81,8,112,3.85714285714286,0.534522483824849,78.5360169491525
6928560176.jpg,1,18,74,13,0,106,2.93396226415094,0.5735249058324,52.2094594594595
5437565452.jpg,0,5,59,40,1,105,3.35238095238095,0.588037027565055,62.7635135135135
5231173987.jpg,10,72,19,1,0,102,2.1078431372549,0.56123736608591,28.6261467889908
8088364175.jpg,4,57,45,2,0,108,2.41666666666667,0.597893498471106,37.50625
