image_name,c1,c2,c3,c4,c5,c_total,MOS,SD,MOS_zscore
8522515607.jpg,0,27,66,11,0,104,2.84615384615385,0.587395613849414,51.0448113207547
107505789.jpg,0,13,64,23,0,100,3.1,0.594588390010563,54.35
9967844514.jpg,0,7,89,56,1,153,3.33333333333333,0.573539334676404,65.2548076923077
2376602512.jpg,2,17,77,12,0,108,2.91666666666667,0.582052443280648,50.7920353982301
10077468576.jpg,0,0,38,66,2,106,3.66037735849057,0.514305679955861,73.8152173913043
6474704871.jpg,0,17,64,25,0,106,3.07547169811321,0.627893124171503,55.65625
9005613417.jpg,0,7,59,37,5,108,3.37037037037037,0.677993088385809,63.7995689655172
8562649420.jpg,0,5,66,37,2,110,3.32727272727273,0.592136404274997,62.4555084745763
5506212777.jpg,0,12,89,39,0,140,3.19285714285714,0.573973009309879,62.2295918367347
2739038267.jpg,0,0,27,68,13,108,3.87037037037037,0.597386716944033,77.4934210526316
2931922629.jpg,0,5,59,41,0,105,3.34285714285714,0.568881686843911,63.5862068965517
9230996141.jpg,0,1,32,68,4,105,3.71428571428571,0.549725206078275,75.1052631578947
4549109010.jpg,0,2,48,53,0,103,3.49514563106796,0.540039693671242,71.125
10609356094.jpg,0,5,51,43,6,105,3.47619047619048,0.680712834732799,67.0
6825162524.jpg,15,72,20,0,0,107,2.04672897196262,0.572699294966035,28.0378151260504
8552550792.jpg,1,31,62,5,0,99,2.71717171717172,0.572149617231404,46.9861111111111
5847946773.jpg,6,40,50,10,0,106,2.60377358490566,0.739101710675986,43.8705357142857
7189264298.jpg,0,0,20,72,13,105,3.93333333333333,0.559303596287842,79.8256302521008
10911095273.jpg,0,1,39,62,5,107,3.66355140186916,0.581863065548848,71.3805309734513
8705060352.jpg,1,33,64,11,0,109,2.77981651376147,0.628899658797715,48.7631578947368
468518360.jpg,0,5,55,41,0,101,3.35643564356436,0.575919411304074,64.8807339449541
10721124556.jpg,0,17,61,31,1,110,3.14545454545455,0.67506525184252,58.4579646017699
7163084628.jpg,0,1,19,77,6,103,3.85436893203884,0.512735206482347,81.0176991150443
6942738260.jpg,0,5,59,42,1,107,3.36448598130841,0.589091455315854,64.3947368421053
4905609957.jpg,1,29,71,4,0,105,2.74285714285714,0.537597422809103,47.1710526315789
5990072932.jpg,0,2,76,32,0,110,3.27272727272727,0.486686812414118,61.7820512820513
8877114673.jpg,3,72,34,2,0,111,2.31531531531532,0.555664744934667,36.4679487179487
5034975248.jpg,0,13,50,41,4,108,3.33333333333333,0.736244575373126,64.5408653846154
6376701103.jpg,1,5,67,30,0,103,3.22330097087379,0.576195072410062,60.7948717948718
6147638271.jpg,0,2,27,71,5,105,3.75238095238095,0.568076247268466,76.5486111111111
4524543534.jpg,0,9,65,30,2,106,3.23584905660377,0.625671247807053,61.8163716814159
8668692139.jpg,1,44,55,1,0,101,2.55445544554455,0.538056642459741,41.725
8041987489.jpg,6,45,40,12,0,103,2.56310679611651,0.775480912302499,43.4181415929204
7295363820.jpg,7,13,40,38,4,102,3.18627450980392,0.951605128158669,60.0441176470588
4495910719.jpg,2,36,54,11,0,103,2.71844660194175,0.677618027171757,45.4661016949153
5967167167.jpg,0,4,54,47,0,105,3.40952380952381,0.566623570867177,65.4934782608696
5290105717.jpg,41,61,4,1,0,107,1.67289719626168,0.595196193031854,17.3513513513514
4583125138.jpg,0,0,42,64,0,106,3.60377358490566,0.491436093467161,71.1608695652174
9767373513.jpg,6,54,39,2,1,102,2.3921568627451,0.67716448336183,36.4977064220183
9034707954.jpg,0,19,64,26,0,109,3.06422018348624,0.642264935495184,57.2302631578947
7878410170.jpg,1,41,62,1,0,105,2.6,0.529876618439831,41.8913043478261
10241895785.jpg,0,4,39,57,3,103,3.57281553398058,0.6199611269846,67.0736607142857
1429848565.jpg,0,4,45,49,2,100,3.49,0.611258017236881,67.8325688073395
8250498441.jpg,1,4,86,31,0,122,3.20491803278689,0.529127218219362,60.8125
4456369143.jpg,0,10,60,39,1,110,3.28181818181818,0.637250662617026,62.385593220339
6864569694.jpg,0,2,62,37,2,103,3.37864077669903,0.562147577692258,65.8851351351351
10265315316.jpg,0,2,67,32,1,102,3.31372549019608,0.526155346500202,62.9513888888889
5667464271.jpg,0,0,30,75,0,105,3.71428571428571,0.453920649501602,74.1176470588235
7822391242.jpg,0,16,57,32,0,105,3.15238095238095,0.661887632529297,60.0441176470588
4358436337.jpg,0,5,48,53,2,108,3.48148148148148,0.61873373074401,64.9201680672269
5517472829.jpg,0,1,25,80,5,111,3.8018018018018,0.519086957504491,75.739406779661
6419135601.jpg,0,3,67,36,3,109,3.35779816513761,0.585676812974409,63.35625
8132808180.jpg,0,13,57,25,1,96,3.14583333333333,0.648547635172405,57.285046728972
5354741393.jpg,0,3,77,22,0,102,3.18627450980392,0.460958797515768,59.2847222222222
6543370923.jpg,0,3,65,36,1,105,3.33333333333333,0.548891657143786,64.9557522123894
8214901795.jpg,0,3,54,47,0,104,3.42307692307692,0.552000909178717,67.3891509433962
2952066894.jpg,0,3,41,53,3,100,3.56,0.608359277155375,70.2702702702703
3560022258.jpg,0,53,44,2,0,99,2.48484848484848,0.541419833394177,38.7683486238532
11006895124.jpg,0,13,41,45,4,103,3.38834951456311,0.757097265084732,66.2567567567568
9351387644.jpg,0,0,10,88,8,106,3.9811320754717,0.41360510440508,84.4491150442478
6142593562.jpg,0,18,73,14,0,105,2.96190476190476,0.553377905438143,52.5804347826087
2300197705.jpg,2,11,54,36,1,104,3.22115384615385,0.723485774166954,59.4736842105263
4750416133.jpg,0,7,50,50,2,109,3.43119266055046,0.643586197816351,65.6016949152542
120328351.jpg,3,51,50,2,0,106,2.4811320754717,0.589287415935903,39.225
6431960911.jpg,0,9,74,17,0,100,3.08,0.50612411142092,54.8142201834862
7908624656.jpg,0,2,15,78,7,102,3.88235294117647,0.532026159690691,82.1768867924528
7331539774.jpg,0,0,35,70,5,110,3.72727272727273,0.540286891324829,74.4539473684211
5449529114.jpg,1,2,33,67,8,111,3.71171171171171,0.665888161335703,72.3804347826087
8608282741.jpg,0,1,35,66,6,108,3.71296296296296,0.58086184639443,75.25
9553679433.jpg,0,0,47,56,1,104,3.55769230769231,0.518154362368228,70.3883928571429
8212033390.jpg,0,0,40,62,0,102,3.6078431372549,0.490642390492787,70.0581896551724
5700146083.jpg,0,3,33,55,9,100,3.7,0.674199862463242,73.0550458715596
10071864114.jpg,0,1,31,76,4,112,3.74107142857143,0.532638100593026,71.9090909090909
139999071.jpg,21,68,14,2,0,105,1.97142857142857,0.642368556700406,25.68125
5859309993.jpg,0,1,49,68,1,119,3.57983193277311,0.528762519494814,71.9358974358974
226477214.jpg,1,51,42,5,0,99,2.51515151515152,0.612183051916503,38.5756302521008
4668832694.jpg,0,0,54,52,0,106,3.49056603773585,0.502285879874493,68.121359223301
7367414528.jpg,2,21,62,20,0,105,2.95238095238095,0.684736788017461,52.4324324324324
7795515978.jpg,1,15,70,27,0,113,3.08849557522124,0.63467542497684,55.0833333333333
79475896.jpg,5,35,63,2,0,105,2.59047619047619,0.615430401227124,42.86875
8311563943.jpg,0,2,42,63,2,109,3.59633027522936,0.563048350911192,70.7905405405405
1500316824.jpg,0,3,42,57,2,104,3.55769230769231,0.588348405414552,72.0955882352941
3722476330.jpg,0,9,54,42,1,106,3.33018867924528,0.643231397498414,62.5905172413793
3606644176.jpg,0,8,51,50,4,113,3.44247787610619,0.680572934809671,67.275
11245083256.jpg,1,9,52,42,5,109,3.37614678899083,0.742730084386975,61.775
8108709244.jpg,0,1,32,65,4,102,3.70588235294118,0.555587910790175,71.0114678899083
8650937010.jpg,1,5,75,26,0,107,3.17757009345794,0.546223468543532,60.296875
2428050358.jpg,1,14,100,24,0,139,3.05755395683453,0.548645026243004,57.4413793103448
6175384810.jpg,0,3,56,42,1,102,3.40196078431373,0.567429568562114,67.0793269230769
3149433848.jpg,43,58,3,0,0,104,1.61538461538462,0.545194225793602,15.4736842105263
2973164436.jpg,6,69,33,1,0,109,2.26605504587156,0.571583275985521,32.5652173913044
9406497605.jpg,0,2,39,66,0,107,3.5981308411215,0.529503382213656,74.0088495575221
31490353.jpg,0,10,52,39,2,103,3.32038834951456,0.6746617486986,61.8081896551724
10079711433.jpg,0,11,93,28,0,132,3.12878787878788,0.530091494771472,59.0625
10196228605.jpg,0,5,62,41,0,108,3.33333333333333,0.563699396261691,63.8040540540541
4278181256.jpg,0,39,59,5,1,104,2.69230769230769,0.608626068135469,45.1913043478261
8455329161.jpg,0,2,17,80,3,102,3.82352941176471,0.495759537405347,79.6129807692308
8465545790.jpg,0,8,69,32,0,109,3.22018348623853,0.566957411770768,62.4509345794393
2365109175.jpg,0,20,78,5,0,103,2.85436893203884,0.472950003374549,51.8871681415929
4953733701.jpg,0,0,12,73,21,106,4.08490566037736,0.55408310410386,82.3114406779661
7265767786.jpg,0,1,44,85,3,133,3.67669172932331,0.530135376942176,76.5845588235294
1429120335.jpg,0,11,71,25,0,107,3.13084112149533,0.567751476149933,59.5675675675676
8346245093.jpg,0,31,64,8,0,103,2.77669902912621,0.576195072410062,49.7361111111111
11520125355.jpg,0,5,44,54,0,103,3.47572815533981,0.591519482286928,65.7477678571429
5125398207.jpg,0,4,78,56,0,138,3.3768115942029,0.543077181953011,67.2989130434783
7092360919.jpg,0,26,66,13,0,105,2.87619047619048,0.599603043290984,50.5
3839953318.jpg,0,12,76,22,0,110,3.09090909090909,0.550986680360738,57.2817796610169
7057320569.jpg,0,5,41,59,0,105,3.51428571428571,0.590213222786179,70.1544117647059
2477552466.jpg,26,69,13,0,0,108,1.87962962962963,0.591490949877323,22.1081081081081
3026852045.jpg,0,0,42,55,4,101,3.62376237623762,0.563053907694722,70.6238317757009
8268523027.jpg,3,38,56,9,0,106,2.66981132075472,0.672191839301104,42.9866071428571
10883456586.jpg,11,74,17,2,0,104,2.09615384615385,0.583248864754567,28.8793103448276
4373225530.jpg,0,5,63,61,0,129,3.43410852713178,0.570703530197462,68.75
6892058753.jpg,0,2,42,61,3,108,3.60185185185185,0.579071361231418,68.85625
9442161547.jpg,0,0,33,73,3,109,3.72477064220183,0.506834029979198,71.614406779661
8183741020.jpg,0,2,48,55,0,105,3.5047619047619,0.539298146522395,66.6283783783784
8317893385.jpg,0,0,27,76,5,108,3.7962962962963,0.5071315569563,75.18125
5912070942.jpg,0,2,54,46,2,104,3.46153846153846,0.573239422405291,69.2706422018349
7354160932.jpg,0,2,54,44,0,100,3.42,0.535223921797827,67.8325688073395
8597381500.jpg,0,3,62,46,0,111,3.38738738738739,0.5422373041587,67.756880733945
7579386834.jpg,0,15,85,20,1,121,3.05785123966942,0.567120220370088,56.5826271186441
4289036535.jpg,7,58,35,1,0,101,2.2970297029703,0.609008283284317,33.2699115044248
4265829347.jpg,0,1,31,68,1,101,3.68316831683168,0.508540914171258,75.6183035714286
6968409021.jpg,0,18,62,29,0,109,3.10091743119266,0.651848569787555,56.6701680672269
11522920033.jpg,0,12,66,25,1,104,3.14423076923077,0.614047043369844,57.3275862068966
8652814108.jpg,1,48,49,3,0,101,2.53465346534653,0.57557547612183,40.9
4591422965.jpg,0,2,29,69,3,103,3.70873786407767,0.553616770564526,76.4391891891892
6079223986.jpg,0,3,66,39,0,108,3.33333333333333,0.529503382213656,63.364406779661
6788897458.jpg,0,2,70,65,0,137,3.45985401459854,0.528797172004346,69.5384615384615
8257779790.jpg,23,76,7,1,0,107,1.86915887850467,0.550884574245936,22.9533898305085
9108357145.jpg,1,40,55,6,0,102,2.64705882352941,0.607658365839589,45.5945945945946
8021456503.jpg,0,0,35,72,2,109,3.69724770642202,0.50008494011783,72.7542016806723
10762659033.jpg,1,47,45,7,0,100,2.58,0.638495706858525,42.25
3130211082.jpg,0,0,21,73,8,102,3.87254901960784,0.520311571307667,76.7697368421053
8377051997.jpg,2,32,65,5,0,104,2.70192307692308,0.589220444222254,45.0491071428571
4525459727.jpg,0,1,30,71,4,106,3.73584905660377,0.539874532027984,76.6
8502191647.jpg,0,0,53,51,0,104,3.49038461538462,0.502328409725477,70.8551401869159
8003457683.jpg,0,14,98,18,0,130,3.03076923076923,0.497099518033221,56.4763779527559
3465087333.jpg,3,63,37,1,0,104,2.34615384615385,0.553352198616052,35.8491379310345
2421141390.jpg,7,59,33,2,0,101,2.2970297029703,0.625212835048123,34.3716216216216
11406584295.jpg,0,10,72,23,0,105,3.12380952380952,0.549391938265845,55.3310810810811
7175697564.jpg,1,0,42,64,4,111,3.63063063063063,0.601935181166513,71.125
8950318830.jpg,0,0,20,66,15,101,3.95049504950495,0.589512300529215,80.3783783783784
11408443745.jpg,0,5,59,36,0,100,3.31,0.563090318750649,63.475
7445811974.jpg,0,5,33,73,2,113,3.63716814159292,0.598539097998721,71.3676470588235
8939389375.jpg,0,0,8,83,19,110,4.1,0.487457361108726,80.3375
4975773859.jpg,0,0,21,73,13,107,3.92523364485981,0.561348352805072,78.1964285714286
7391355184.jpg,0,1,20,87,3,111,3.82882882882883,0.464638155868215,77.5064102564103
7913897946.jpg,0,10,69,28,0,107,3.16822429906542,0.574390264219721,59.9802631578947
5602472061.jpg,0,6,60,37,1,104,3.31730769230769,0.595524131992075,60.8310810810811
356523006.jpg,0,3,67,36,3,109,3.35779816513761,0.585676812974409,64.3986486486486
11209221046.jpg,1,12,57,26,1,97,3.14432989690722,0.676844558743757,58.75
9482519952.jpg,0,9,70,22,0,101,3.12871287128713,0.541541620498991,57.5047169811321
4086204414.jpg,15,66,20,0,0,101,2.04950495049505,0.589512300529215,27.625
6040260022.jpg,2,59,35,7,0,103,2.45631067961165,0.653447854545654,38.3252427184466
2960552821.jpg,16,77,8,0,0,101,1.92079207920792,0.483387387440584,23.9565217391304
3206690420.jpg,0,17,63,23,0,103,3.05825242718447,0.623482356912612,56.6682242990654
11270280904.jpg,13,57,30,5,0,105,2.25714285714286,0.734173677688726,31.7702702702703
3892086124.jpg,0,15,83,40,1,139,3.19424460431655,0.62412486954026,61.2928082191781
5309326426.jpg,0,0,37,64,2,103,3.66019417475728,0.515512272504728,71.0884955752212
9000701354.jpg,0,2,30,70,5,107,3.72897196261682,0.575770090678299,75.7126168224299
10089027076.jpg,29,66,11,2,0,108,1.87037037037037,0.656991053760519,23.0785714285714
8988143845.jpg,0,3,62,37,1,103,3.3495145631068,0.554990511561316,63.9336283185841
8904864157.jpg,0,2,65,66,0,133,3.4812030075188,0.530886961651435,68.5656934306569
2927008302.jpg,0,12,62,26,2,102,3.17647058823529,0.651149246110707,58.1554054054054
9200093125.jpg,0,3,57,38,0,98,3.35714285714286,0.542046522901578,62.875
8570770544.jpg,0,5,72,27,0,104,3.21153846153846,0.515263659967445,59.2478448275862
4273357838.jpg,0,3,59,47,0,109,3.40366972477064,0.546356044118937,64.25
5265556048.jpg,0,0,42,64,4,110,3.65454545454545,0.549167236712308,70.4663865546218
8171751224.jpg,0,1,74,61,2,138,3.46376811594203,0.542492494345536,68.1538461538462
434127863.jpg,1,11,60,31,2,105,3.20952380952381,0.689135998848141,58.3080357142857
6286044979.jpg,0,2,54,45,1,102,3.44117647058824,0.555325779182854,66.3060747663551
5619807447.jpg,0,5,47,46,4,102,3.48039215686275,0.655976215411352,64.7293577981651
6280923250.jpg,0,0,45,57,3,105,3.6,0.547722557505166,69.7737068965517
5416465084.jpg,1,20,99,7,0,127,2.88188976377953,0.4816336819872,52.0590551181102
8702518420.jpg,0,0,27,73,6,106,3.80188679245283,0.524083078124337,76.9568965517241
6289164461.jpg,16,71,17,0,0,104,2.00961538461538,0.56594610720975,25.8223684210526
10625988224.jpg,0,4,59,38,1,102,3.35294117647059,0.574146957824214,66.8443396226415
4961486371.jpg,1,6,61,40,3,111,3.34234234234234,0.667362454272523,62.7351694915254
6143020134.jpg,1,4,65,60,2,132,3.43939393939394,0.62097652421578,68.5277777777778
8520990466.jpg,0,9,77,20,0,106,3.10377358490566,0.515091213060161,58.0929203539823
2768178889.jpg,1,47,52,4,0,104,2.56730769230769,0.587316144781357,42.6880530973451
9094228395.jpg,0,8,54,40,1,103,3.33009708737864,0.63227490785977,61.3053097345133
8885623781.jpg,0,3,31,65,1,100,3.64,0.559942276967326,74.125
5952945336.jpg,0,0,56,54,1,111,3.5045045045045,0.520032759000883,67.6991525423729
8460376605.jpg,0,0,24,72,7,103,3.83495145631068,0.525750395161586,78.7857142857143
6608146543.jpg,0,3,62,36,0,101,3.32673267326733,0.531204497177671,63.4861111111111
3241749396.jpg,0,8,80,18,0,106,3.09433962264151,0.488502120418315,58.5943396226415
5628885328.jpg,0,3,50,49,0,102,3.45098039215686,0.556286324530138,69.4092920353982
5500570132.jpg,0,5,69,27,1,102,3.23529411764706,0.548200848288349,63.9855769230769
8354529751.jpg,0,0,40,62,1,103,3.62135922330097,0.507135454975797,69.5384615384615
4658471909.jpg,15,63,24,1,0,103,2.10679611650485,0.640352558517928,29.2432432432432
2113239475.jpg,1,12,71,23,2,109,3.11926605504587,0.648713408190937,58.5328947368421
8596361580.jpg,0,0,49,52,3,104,3.55769230769231,0.554363504117592,66.4054054054054
5227449110.jpg,0,0,30,70,7,107,3.78504672897196,0.549923448929572,74.9726890756303
6643932717.jpg,9,75,22,1,0,107,2.14018691588785,0.55709147195867,30.1351351351351
5180032640.jpg,0,2,60,42,3,107,3.42990654205607,0.584584185920639,68.2
9062040259.jpg,1,10,58,34,2,105,3.24761904761905,0.69033091815214,59.2435897435897
8596963541.jpg,4,38,56,7,0,105,2.62857142857143,0.66876957709868,42.7702702702703
2631446955.jpg,0,0,17,74,17,108,4.0,0.563699396261691,79.925
11087687983.jpg,0,0,17,91,3,111,3.87387387387387,0.407143421616715,76.0889830508475
5685134916.jpg,0,3,65,30,2,100,3.31,0.563090318750649,63.6697247706422
8599891034.jpg,0,6,63,40,1,110,3.32727272727273,0.592136404274997,62.7302631578947
9687081006.jpg,0,3,50,47,1,101,3.45544554455446,0.574886988463777,66.4701834862385
11201160185.jpg,0,8,65,34,0,107,3.24299065420561,0.580193876108751,62.3197115384615
7974813040.jpg,0,1,53,88,0,142,3.61267605633803,0.503161516153142,74.4893617021277
156451756.jpg,1,29,52,17,0,99,2.85858585858586,0.700001472448903,48.0735294117647
2615955728.jpg,0,4,49,43,6,102,3.5,0.671189279938938,66.7828947368421
6956011813.jpg,2,27,64,6,0,99,2.74747474747475,0.594934987760785,46.0344036697248
3794461596.jpg,0,3,48,50,3,104,3.50961538461538,0.607320908240659,71.0441176470588
8020768393.jpg,0,0,30,70,3,103,3.7378640776699,0.504123487994673,72.8191964285714
10295875445.jpg,0,6,54,48,1,109,3.40366972477064,0.610392497512353,62.563025210084
8710431611.jpg,0,2,37,57,6,102,3.65686274509804,0.621322416568889,72.925
5227846365.jpg,2,56,46,1,0,105,2.43809523809524,0.553377905438143,38.5919811320755
9916890605.jpg,0,8,72,19,0,99,3.11111111111111,0.512872838774715,56.1285046728972
5308397567.jpg,0,0,23,75,3,101,3.8019801980198,0.469463565789679,74.0389908256881
8228733135.jpg,0,10,65,29,0,104,3.18269230769231,0.587316144781357,59.9181415929204
11260270773.jpg,0,0,37,61,4,102,3.67647058823529,0.547935182729598,72.3513513513514
7892635308.jpg,0,0,37,65,2,104,3.66346153846154,0.51408466914511,70.4551282051282
5830228003.jpg,1,3,62,36,0,102,3.30392156862745,0.576593198502975,64.5555555555556
11419816946.jpg,0,0,34,84,3,121,3.74380165289256,0.492086131008158,76.14375
5176288733.jpg,0,0,37,59,4,100,3.67,0.551490175924662,73.45
2753587179.jpg,1,4,63,26,1,95,3.23157894736842,0.591655297484467,61.6850961538462
11301386435.jpg,0,2,28,69,11,110,3.80909090909091,0.628022300566103,76.1512605042017
42490373.jpg,0,14,46,40,3,103,3.31067961165049,0.741343854139519,62.9461206896552
10819132874.jpg,0,1,34,66,2,103,3.66990291262136,0.531153932759187,75.7798165137615
7470832570.jpg,0,5,65,31,2,103,3.29126213592233,0.587968719342113,63.7
4243875190.jpg,0,1,38,59,3,101,3.63366336633663,0.560763270502406,69.1949541284404
10693826785.jpg,0,19,68,17,0,104,2.98076923076923,0.590881671836269,53.2757009345794
4162338388.jpg,1,7,50,48,0,106,3.36792452830189,0.652109714667755,66.5373831775701
8123324192.jpg,0,4,65,34,0,103,3.29126213592233,0.535615240179964,64.1995412844037
4710464067.jpg,0,0,31,65,5,101,3.74257425742574,0.541358759909446,73.3918918918919
10723077086.jpg,0,7,34,64,1,106,3.55660377358491,0.633661899923134,71.8529411764706
5565514955.jpg,1,33,53,13,1,101,2.8019801980198,0.707386768044159,45.9587155963303
3452963187.jpg,21,71,20,0,0,112,1.99107142857143,0.607691477469391,25.3040540540541
8507554609.jpg,0,3,75,28,0,106,3.23584905660377,0.488961714198037,62.4086956521739
5384624254.jpg,0,2,55,51,1,109,3.46788990825688,0.553922165602138,67.5593220338983
2688019250.jpg,0,14,83,10,0,107,2.96261682242991,0.474346295857342,52.8571428571429
4504355317.jpg,0,0,15,80,7,102,3.92156862745098,0.460010213184165,78.5654205607477
10737029565.jpg,0,6,60,38,1,105,3.32380952380952,0.596387169276516,63.0172413793103
5590179803.jpg,0,12,61,28,0,101,3.15841584158416,0.612089425939163,57.475
51433626.jpg,6,49,45,9,0,109,2.52293577981651,0.727709881589845,40.8181818181818
8137649050.jpg,0,5,44,60,1,110,3.51818181818182,0.601707328988215,69.1673728813559
8228841274.jpg,0,5,68,36,0,109,3.28440366972477,0.545889405419606,61.84375
5856115357.jpg,1,17,77,11,0,106,2.92452830188679,0.546819604754398,52.1351351351351
6224584485.jpg,1,70,27,5,0,103,2.3495145631068,0.589262381454646,36.0046728971963
9419183210.jpg,0,2,37,69,3,111,3.65765765765766,0.564003473482139,69.9364406779661
2231043641.jpg,0,5,75,22,0,102,3.16666666666667,0.489156342484424,57.625
6343807770.jpg,0,5,57,41,2,105,3.38095238095238,0.610500305250229,66.509900990099
5437634548.jpg,2,9,60,34,0,105,3.2,0.670820393249937,57.9324324324324
10264984793.jpg,0,4,45,50,2,101,3.4950495049505,0.610307502431973,66.1
82183009.jpg,6,60,36,3,0,105,2.34285714285714,0.632889761766969,36.13125
8617920561.jpg,0,9,59,31,1,100,3.24,0.621500302705177,61.2477064220183
3108798537.jpg,0,13,68,20,0,101,3.06930693069307,0.570217953813702,56.3279816513761
8637618858.jpg,0,2,39,57,1,99,3.57575757575758,0.554957418681078,73.2071428571429
6979435146.jpg,0,0,14,85,3,102,3.8921568627451,0.395691217373967,81.1637168141593
7331542456.jpg,0,6,46,45,4,101,3.46534653465347,0.671779077311039,64.5691964285714
3100238639.jpg,1,18,58,24,1,102,3.05882352941176,0.701109861474453,55.537610619469
5602195949.jpg,0,1,48,59,2,110,3.56363636363636,0.550683857210433,71.5833333333333
7113461019.jpg,2,23,96,11,0,132,2.87878787878788,0.552997425974477,51.5076335877863
5185255513.jpg,0,0,57,71,3,131,3.58778625954198,0.538805359570648,72.8125
8427827661.jpg,1,12,71,22,0,106,3.07547169811321,0.59678684409646,54.4827586206897
5880272825.jpg,0,2,39,73,2,116,3.64655172413793,0.54779098433503,75.7478448275862
2928622708.jpg,0,11,75,20,0,106,3.08490566037736,0.536619480829526,55.6206896551724
6957057987.jpg,0,11,58,35,0,104,3.23076923076923,0.626761892986781,59.9836448598131
5670774641.jpg,0,1,46,55,0,102,3.52941176470588,0.520964116757892,66.9243119266055
272411695.jpg,46,59,2,0,0,107,1.58878504672897,0.531165877300352,15.2627118644068
3669066809.jpg,7,53,43,7,1,111,2.47747747747748,0.748900367773819,40.031512605042
8027425918.jpg,0,0,26,72,3,101,3.77227722772277,0.487466678221433,75.1
10068778516.jpg,0,1,38,71,4,114,3.68421052631579,0.55360107476116,71.8782608695652
8405979865.jpg,1,23,95,9,0,128,2.875,0.51741331199832,52.1240157480315
5977893194.jpg,0,17,59,31,0,107,3.13084112149533,0.659961579063691,59.6907894736842
2980838635.jpg,0,4,60,46,0,110,3.38181818181818,0.558205154187778,65.3648648648649
5568534829.jpg,0,9,62,26,0,97,3.17525773195876,0.577536241257322,58.3080357142857
3809644203.jpg,0,8,76,24,0,108,3.14814814814815,0.526224691975906,60.8514150943396
3983499964.jpg,0,7,55,45,1,108,3.37037037037037,0.62040976197892,67.1542056074766
5347293716.jpg,0,3,50,47,0,100,3.44,0.55632270266002,63.5183486238532
8398239689.jpg,2,9,74,22,0,107,3.08411214953271,0.600652087901185,56.4137168141593
8179397976.jpg,0,0,42,58,2,102,3.6078431372549,0.529465688920931,71.0093457943925
215794898.jpg,1,18,66,19,0,104,2.99038461538462,0.630844591938848,52.7878151260504
2280668053.jpg,1,34,63,9,0,107,2.74766355140187,0.615728712988593,48.0907079646018
5459372516.jpg,0,4,65,61,1,131,3.45038167938931,0.571283850476818,68.41796875
6030228496.jpg,0,0,21,83,3,107,3.83177570093458,0.444801870423548,79.7094594594595
7005727843.jpg,0,2,48,50,5,105,3.55238095238095,0.619878281801423,68.1049107142857
4867994945.jpg,30,75,5,0,0,110,1.77272727272727,0.518627173527317,21.025641025641
6845434524.jpg,0,2,42,66,0,110,3.58181818181818,0.531258125581778,74.1041666666667
3711772310.jpg,4,54,45,4,0,107,2.45794392523365,0.63365328642089,38.9797297297297
1807195948.jpg,4,71,23,2,0,100,2.23,0.547814758929522,34.0
5288290650.jpg,0,0,39,58,4,101,3.65346534653465,0.555619358272486,74.0818584070797
5933359823.jpg,0,15,77,16,0,108,3.00925925925926,0.538175706470443,53.3947368421053
5513962677.jpg,0,3,53,46,3,105,3.46666666666667,0.605530070819498,67.0
8523298395.jpg,0,3,58,41,0,102,3.37254901960784,0.543577599321548,66.7620192307692
5690945868.jpg,0,0,32,72,4,108,3.74074074074074,0.518271216306465,74.9630434782609
3697493807.jpg,0,0,8,84,13,105,4.04761904761905,0.446803871551825,82.2909482758621
3976452832.jpg,0,11,83,16,0,110,3.04545454545455,0.495602008799337,55.2567567567568
6728176335.jpg,0,2,57,45,3,107,3.45794392523365,0.587292698581456,66.9306722689076
7641363622.jpg,0,6,59,43,0,108,3.34259259259259,0.58264682938731,66.0833333333333
7533737270.jpg,0,0,14,72,22,108,4.07407407407407,0.575248076573871,81.23125
4862383971.jpg,0,3,63,40,0,106,3.34905660377358,0.535278349133619,65.7547169811321
5888106239.jpg,0,1,40,65,0,106,3.60377358490566,0.510447894510187,73.3348214285714
8679754087.jpg,2,16,62,30,0,110,3.09090909090909,0.697905839255595,55.0833333333333
11436508006.jpg,0,5,72,44,0,121,3.32231404958678,0.550982093372943,65.14375
9429089796.jpg,0,2,25,71,10,108,3.82407407407407,0.608793869688389,73.53125
5711022887.jpg,0,3,68,35,0,106,3.30188679245283,0.519520132443754,63.1260869565217
7893560424.jpg,0,9,71,24,1,105,3.16190476190476,0.573850180189942,57.8965517241379
2415583702.jpg,21,56,25,4,0,106,2.11320754716981,0.759959331204871,29.3156779661017
6127342377.jpg,3,62,39,0,0,104,2.34615384615385,0.535519542113137,35.1478260869565
5803914327.jpg,0,46,60,4,0,110,2.61818181818182,0.558205154187778,43.2905405405405
6748287295.jpg,0,6,52,32,4,94,3.36170212765957,0.669634209725081,66.3653846153846
8714823724.jpg,0,2,42,57,2,103,3.57281553398058,0.570550847480092,71.3108108108108
10692667386.jpg,0,0,46,52,5,103,3.60194174757282,0.583091924701258,71.9033018867924
2292384520.jpg,0,4,56,42,0,102,3.37254901960784,0.561496737908777,66.9236111111111
9919248523.jpg,0,3,44,53,1,101,3.51485148514851,0.576434929304924,68.35
5275524338.jpg,0,3,32,68,2,105,3.65714285714286,0.568881686843911,74.8680555555556
9544478990.jpg,0,1,23,69,8,101,3.83168316831683,0.566909286053652,77.8326086956522
7445548804.jpg,0,16,75,12,0,103,2.96116504854369,0.522481449095346,54.9655963302752
6075825527.jpg,0,11,63,29,1,104,3.19230769230769,0.624374219953223,62.3088235294118
4252888669.jpg,0,2,30,66,2,100,3.68,0.548275533473873,74.8715596330275
5768167934.jpg,0,1,13,70,29,113,4.12389380530973,0.628671265488227,83.6410256410256
8406491085.jpg,0,0,38,68,0,106,3.64150943396226,0.481835364992828,72.625
8451928629.jpg,0,0,20,86,4,110,3.85454545454545,0.445906223661714,73.7941176470588
9683345746.jpg,0,11,61,31,1,104,3.21153846153846,0.633576332717798,59.5460526315789
5444850191.jpg,0,4,53,47,1,105,3.42857142857143,0.586009038673119,67.2334905660377
10027582235.jpg,0,0,24,78,5,107,3.82242990654206,0.491687201381957,77.1377118644068
6001444866.jpg,9,83,17,1,0,110,2.09090909090909,0.516613079807823,29.1470588235294
430051470.jpg,0,10,96,35,0,141,3.17730496453901,0.538300074882063,62.2857142857143
5593028853.jpg,0,9,60,33,1,103,3.25242718446602,0.621800778289325,61.8341121495327
398551269.jpg,1,37,56,13,0,107,2.75700934579439,0.670695520369644,48.7905405405405
9941134286.jpg,0,2,55,50,1,108,3.46296296296296,0.554099858167321,65.9048672566372
6326886913.jpg,0,52,54,0,0,106,2.50943396226415,0.502285879874493,41.0614406779661
5958950790.jpg,7,68,32,1,0,108,2.25,0.582052443280648,33.3067226890756
5585956743.jpg,0,6,54,40,0,100,3.34,0.589812502307969,62.4930555555556
561215186.jpg,0,1,66,40,0,107,3.36448598130841,0.502681927350329,63.4955752212389
6845848072.jpg,0,2,28,77,4,111,3.74774774774775,0.547198957808492,77.3125
8985551582.jpg,5,53,43,10,0,111,2.52252252252252,0.724215523506728,42.9673913043478
2713735764.jpg,0,31,97,11,0,139,2.85611510791367,0.532442431795113,51.568345323741
3084860790.jpg,60,37,6,0,0,103,1.47572815533981,0.607867700295262,12.1850961538462
8338842182.jpg,0,3,58,48,0,109,3.41284403669725,0.547908636177939,67.2920353982301
8417199212.jpg,0,4,52,48,1,105,3.43809523809524,0.587101903155359,64.2008928571429
4360193081.jpg,0,2,38,62,0,102,3.58823529411765,0.53311973979568,72.8235294117647
5498204974.jpg,7,65,27,2,0,101,2.23762376237624,0.602470162771322,33.688679245283
6073381897.jpg,0,1,36,72,1,110,3.66363636363636,0.511828395971184,73.1346153846154
3922421993.jpg,0,2,40,58,3,103,3.60194174757282,0.583091924701258,72.0416666666667
10226277514.jpg,2,44,55,5,0,106,2.59433962264151,0.613782990761741,43.2162162162162
2448776548.jpg,2,9,70,28,1,110,3.15454545454545,0.652255981105123,56.75625
4302524395.jpg,2,62,74,2,0,140,2.54285714285714,0.554529142041311,42.530612244898
6469192803.jpg,8,71,29,0,0,108,2.19444444444444,0.554646192409084,32.0848214285714
8253280616.jpg,0,7,66,26,0,99,3.19191919191919,0.54728956773763,61.7570093457944
496162577.jpg,4,35,64,7,0,110,2.67272727272727,0.651168193848999,45.3163716814159
5142391146.jpg,1,25,76,6,0,108,2.80555555555556,0.53753214784685,48.4894957983193
5588234773.jpg,21,65,17,2,0,105,2.0,0.665062171761176,25.3644859813084
6793966090.jpg,1,3,55,50,1,110,3.42727272727273,0.612695816428967,63.15
9258059092.jpg,0,9,65,73,8,155,3.51612903225806,0.687124997699358,71.046178343949
4689159899.jpg,10,84,11,0,0,105,2.00952380952381,0.449256610225717,27.2697368421053
8259404043.jpg,0,1,27,73,0,101,3.71287128712871,0.476164544319846,74.65
4187182991.jpg,1,30,73,9,0,113,2.79646017699115,0.584918981498998,46.9343220338983
5403603296.jpg,0,0,35,57,7,99,3.71717171717172,0.589714632481972,74.4174311926605
4548596684.jpg,1,15,66,23,0,105,3.05714285714286,0.632889761766969,57.070796460177
4689181626.jpg,0,29,58,11,0,98,2.81632653061224,0.615050727528389,49.7791262135922
5673447503.jpg,0,4,70,26,0,100,3.22,0.504124403437697,59.8853211009174
8347284037.jpg,0,8,75,29,1,113,3.20353982300885,0.569449797664976,57.9809322033898
11522984926.jpg,1,58,77,3,0,139,2.58992805755396,0.549214849861617,44.3826530612245
8860399629.jpg,3,50,62,3,0,118,2.55084745762712,0.593374496225831,42.6730769230769
6050570749.jpg,2,45,70,6,0,123,2.65040650406504,0.600324227115871,45.5909090909091
5174677992.jpg,0,29,69,9,0,107,2.81308411214953,0.568527411288765,47.845652173913
6306859998.jpg,0,1,28,77,4,110,3.76363636363636,0.523349703761283,72.3625
9433458685.jpg,1,6,31,62,7,107,3.63551401869159,0.731920752547138,70.2584033613445
3482375790.jpg,0,3,64,34,0,101,3.30693069306931,0.524262801606708,62.05
4940996206.jpg,0,0,54,52,0,106,3.49056603773585,0.502285879874493,69.0067567567568
5794758875.jpg,1,17,62,17,1,98,3.0,0.658019521535379,49.5508849557522
9353536560.jpg,1,14,80,29,0,124,3.10483870967742,0.609125034050699,59.5614754098361
6652263581.jpg,0,28,67,13,0,108,2.86111111111111,0.60308139177812,49.5987394957983
6703759327.jpg,0,7,48,48,0,103,3.39805825242718,0.615801817897875,66.7642857142857
5824082232.jpg,2,43,85,9,1,140,2.74285714285714,0.627561554450933,48.025
3847022878.jpg,0,0,60,39,2,101,3.42574257425743,0.535659120214812,66.475
9505522131.jpg,0,13,41,54,4,112,3.4375,0.744726202786714,66.5769230769231
7914714726.jpg,0,0,17,76,8,101,3.91089108910891,0.491914828013755,76.9717391304348
8492640738.jpg,0,17,61,17,0,95,3.0,0.601416767025641,53.8970588235294
6630214003.jpg,0,1,29,66,7,103,3.76699029126214,0.580802073794872,72.7972972972973
9401118786.jpg,3,15,71,20,0,109,2.99082568807339,0.659621283656411,52.5986842105263
7861079240.jpg,0,2,33,72,2,109,3.67889908256881,0.542298502346539,70.5656779661017
7089392359.jpg,0,1,31,70,3,105,3.71428571428571,0.531946456861058,71.8310810810811
4018879156.jpg,7,50,44,3,0,104,2.41346153846154,0.662601183671924,38.2867647058824
10213881683.jpg,5,77,52,2,0,136,2.375,0.582936372869986,37.1232142857143
7051563883.jpg,0,12,68,26,1,107,3.14953271028037,0.611273621185864,57.8891304347826
1296759644.jpg,4,69,26,1,0,100,2.24,0.534090371802868,32.1320754716981
414892775.jpg,0,5,69,36,0,110,3.28181818181818,0.544055754391562,61.1071428571429
1240561841.jpg,0,0,24,78,6,108,3.83333333333333,0.502331014967353,74.5508474576271
7196174704.jpg,0,16,70,15,0,101,2.99009900990099,0.556687515666563,56.1322115384615
5592040758.jpg,0,3,43,65,2,113,3.58407079646018,0.578261923427409,69.1673728813559
8321981131.jpg,1,12,58,31,2,104,3.20192307692308,0.702005555427188,59.6261061946903
7841962592.jpg,0,2,46,52,3,103,3.54368932038835,0.590392010499209,69.0442477876106
9049275396.jpg,0,3,41,56,2,102,3.55882352941176,0.589907349861894,68.8
4157689684.jpg,3,35,59,12,0,109,2.73394495412844,0.689097663277484,47.141592920354
3106852276.jpg,0,3,38,60,5,106,3.63207547169811,0.622215269716858,72.4481132075472
8020716606.jpg,0,2,33,74,1,110,3.67272727272727,0.526527326788343,73.275641025641
5960283649.jpg,0,48,56,7,0,111,2.63063063063063,0.601935181166513,43.7625
9680493700.jpg,21,82,4,0,1,108,1.87037037037037,0.548448833735682,22.0995575221239
5828251146.jpg,0,15,59,21,1,96,3.08333333333333,0.643455583330581,56.1322115384615
4952399474.jpg,0,11,76,24,0,111,3.11711711711712,0.551670829698929,59.8260869565217
4107362083.jpg,0,1,17,69,17,104,3.98076923076923,0.607090294635138,80.75
9036022986.jpg,0,3,54,46,1,104,3.43269230769231,0.57054603512134,68.4558823529412
8393175128.jpg,0,2,44,58,1,105,3.55238095238095,0.554369919210997,68.9324324324324
5681785926.jpg,0,5,58,35,1,99,3.32323232323232,0.586032715327688,61.9883177570093
5683735781.jpg,0,7,74,25,0,106,3.16981132075472,0.525025135238804,60.9872881355932
4130373740.jpg,0,12,79,15,1,107,3.04672897196262,0.538747281569002,55.9742990654206
2951329736.jpg,0,1,29,71,7,108,3.77777777777778,0.569199032800311,74.0818584070797
7520058110.jpg,0,2,57,39,1,99,3.39393939393939,0.54991987947377,64.9564220183486
8710250301.jpg,0,4,71,79,1,155,3.49677419354839,0.562625957596049,70.1003184713376
1565882132.jpg,1,40,59,3,0,103,2.62135922330097,0.562147577692258,43.5878378378378
9365989820.jpg,0,20,61,21,0,102,3.00980392156863,0.637058494589801,55.247641509434
7640299878.jpg,0,2,37,65,2,106,3.63207547169811,0.557639099847156,68.5608108108108
10265809113.jpg,0,0,36,65,2,103,3.66990291262136,0.512363793752346,73.7767857142857
7222733996.jpg,0,0,24,73,3,100,3.79,0.477683805651624,76.9
5999140032.jpg,6,31,57,6,2,102,2.67647058823529,0.759908341344662,43.7920560747664
2431828879.jpg,1,18,64,23,1,107,3.04672897196262,0.678277195660231,54.4516806722689
4529654985.jpg,5,80,23,0,0,108,2.16666666666667,0.483368244522832,32.1822033898305
457397602.jpg,2,34,68,6,0,110,2.70909090909091,0.595787268010937,47.3606194690265
5926348208.jpg,0,13,55,35,0,103,3.21359223300971,0.651551473248295,59.1183035714286
6343064519.jpg,0,0,21,72,8,101,3.87128712871287,0.522749774493183,77.6180555555556
8387487827.jpg,0,6,57,51,0,114,3.39473684210526,0.589261140070359,65.0588235294118
7555880012.jpg,0,32,73,5,0,110,2.75454545454545,0.527872024321917,47.5796460176991
7668828488.jpg,0,1,42,59,2,104,3.59615384615385,0.548948346186761,70.675
5129172.jpg,42,60,5,0,0,107,1.65420560747664,0.568061977390618,18.5399159663866
3093435000.jpg,0,0,28,77,3,108,3.76851851851852,0.485422669308056,73.4474789915966
136287514.jpg,27,64,13,0,0,104,1.86538461538462,0.608319223614763,22.79375
3840546727.jpg,0,20,78,15,0,113,2.95575221238938,0.557247388812915,52.8571428571429
3577744786.jpg,15,74,13,1,0,103,2.0,0.560112033611204,27.0526315789474
6337822588.jpg,2,37,92,7,0,138,2.7536231884058,0.5642848869312,47.9105839416058
4685744038.jpg,0,1,27,62,10,100,3.81,0.614554121031474,75.3199152542373
5158869275.jpg,0,36,108,8,0,152,2.81578947368421,0.507180919580455,50.9729299363057
8242811234.jpg,0,3,56,41,0,100,3.38,0.546430104025994,66.394495412844
4178406108.jpg,2,81,24,0,0,107,2.20560747663551,0.450121949031789,32.2125
6366586615.jpg,5,50,48,3,0,106,2.4622641509434,0.635078222431983,38.6939655172414
3052939128.jpg,0,1,34,62,7,104,3.72115384615385,0.598651085134435,73.1875
9733980007.jpg,0,36,62,5,0,103,2.69902912621359,0.557215617370319,43.6495535714286
7744113492.jpg,1,20,70,14,0,105,2.92380952380952,0.599603043290984,52.1205357142857
5511925995.jpg,0,1,28,72,8,109,3.79816513761468,0.573808209566535,73.1525423728814
468764619.jpg,1,10,58,32,0,101,3.1980198019802,0.648379549032787,58.6065217391304
6711319143.jpg,0,2,29,57,19,107,3.86915887850467,0.714857317199347,74.5625
9324654543.jpg,1,7,89,29,0,126,3.15873015873016,0.542773594239048,61.456
6930075142.jpg,0,32,60,13,0,105,2.81904761904762,0.632165879839856,51.2208737864078
3120415423.jpg,0,8,83,32,0,123,3.19512195121951,0.53803736516851,60.4545454545455
7946380974.jpg,0,3,54,50,0,107,3.4392523364486,0.552482734186941,67.9930555555556
34713269.jpg,12,55,31,4,0,102,2.26470588235294,0.716516194647949,34.0
1289162225.jpg,0,4,73,36,0,113,3.28318584070796,0.525578364224196,62.1470588235294
5891437045.jpg,0,4,72,28,1,105,3.24761904761905,0.533150151691889,61.8055555555556
7613152858.jpg,0,0,27,75,5,107,3.79439252336449,0.509130182355242,73.9241071428571
3609983548.jpg,0,6,64,36,0,106,3.28301886792453,0.564922531244132,62.6148648648649
2656455723.jpg,1,34,68,10,0,113,2.76991150442478,0.612501451274113,48.0818965517241
1494601659.jpg,10,63,27,2,0,102,2.20588235294118,0.634615893715864,31.0481651376147
8620919369.jpg,1,63,74,2,0,140,2.55,0.540782805907758,42.0732142857143
9249869281.jpg,27,66,8,0,0,101,1.81188118811881,0.560586679954647,19.5817757009346
8356375190.jpg,0,1,30,90,3,124,3.76612903225806,0.495653809288772,78.6311475409836
7780172596.jpg,0,1,37,55,4,97,3.63917525773196,0.580688653854005,73.8082524271845
8325420861.jpg,0,3,55,50,0,108,3.43518518518519,0.551516992869059,68.5894495412844
7705365342.jpg,0,9,58,32,0,99,3.23232323232323,0.603193589736869,61.6527777777778
4819847439.jpg,19,63,22,3,0,107,2.08411214953271,0.702038747077514,28.5743243243243
3962244093.jpg,0,2,48,48,1,99,3.48484848484848,0.559949639930132,67.0771028037383
9538674147.jpg,1,30,65,4,0,100,2.72,0.55194788218315,45.6559633027523
6158806771.jpg,48,51,6,1,0,106,1.62264150943396,0.639238090954555,16.8008474576271
629401204.jpg,2,44,55,6,0,107,2.60747663551402,0.625812820074585,43.7058823529412
2376113642.jpg,4,71,30,0,0,105,2.24761904761905,0.514799295860353,31.6959459459459
8353492181.jpg,9,78,22,0,0,109,2.11926605504587,0.52218860368506,29.9449152542373
7297259404.jpg,0,7,57,45,0,109,3.34862385321101,0.599013800449923,64.1756756756757
304760277.jpg,0,1,34,63,2,100,3.66,0.535978289926679,74.2660550458716
10856757.jpg,17,59,28,5,0,109,2.19266055045872,0.751258995388106,32.2954545454545
5651460875.jpg,0,0,45,60,1,106,3.58490566037736,0.513956168750047,69.6517857142857
4127400247.jpg,2,37,96,3,0,138,2.72463768115942,0.523437765206351,47.0721830985916
2138715193.jpg,0,20,70,17,0,107,2.97196261682243,0.590138198161191,53.425
4244935320.jpg,0,7,51,47,2,107,3.41121495327103,0.64359355256743,64.1575630252101
10258169584.jpg,0,10,70,25,0,105,3.14285714285714,0.562080124122946,57.2302631578947
3378003631.jpg,0,3,62,32,0,97,3.29896907216495,0.523707704211206,63.1129807692308
1392405539.jpg,0,5,64,28,0,97,3.23711340206186,0.535669283005862,60.752427184466
6530075543.jpg,0,1,19,84,3,107,3.83177570093458,0.46552833260779,81.2640186915888
3505262206.jpg,0,25,69,9,0,103,2.84466019417476,0.55584737560646,50.4269911504425
5316693478.jpg,0,8,72,23,0,103,3.14563106796116,0.531512215385263,58.3157894736842
4026925102.jpg,0,6,56,42,3,107,3.39252336448598,0.640710238952061,65.8214285714286
2142428164.jpg,0,1,35,67,5,108,3.7037037037037,0.567981493368036,74.0088495575221
6746049049.jpg,0,7,65,34,1,107,3.27102803738318,0.591928308030625,62.077731092437
5053500577.jpg,0,3,57,43,1,104,3.40384615384615,0.566358334015961,65.1584821428571
6537249483.jpg,0,2,24,68,12,106,3.84905660377358,0.629322429740926,75.3217391304348
7393631040.jpg,0,0,30,75,7,112,3.79464285714286,0.539241924632955,75.7435897435897
4696097531.jpg,0,7,60,39,0,106,3.30188679245283,0.588295541547658,64.3567961165049
5036262446.jpg,0,1,45,53,1,100,3.54,0.539734315485991,68.2336448598131
9344542617.jpg,5,81,25,0,0,111,2.18018018018018,0.489864511847143,30.9237288135593
7328195954.jpg,0,2,39,65,2,108,3.62037037037037,0.558997644196006,72.1652173913044
7013076503.jpg,0,1,71,34,1,107,3.32710280373832,0.50982240590043,64.375
8380369304.jpg,6,49,44,1,0,100,2.4,0.619546918189723,36.925
4265877256.jpg,0,37,105,5,0,147,2.78231292517007,0.489856098561148,50.226821192053
3649082846.jpg,1,14,76,13,1,105,2.99047619047619,0.58004041794248,53.25
5197644731.jpg,0,12,70,21,0,103,3.0873786407767,0.561978230624793,56.5707547169811
5014526130.jpg,0,0,67,62,0,129,3.48062015503876,0.50157214077648,69.9154135338346
6696763655.jpg,0,22,78,5,0,105,2.83809523809524,0.482856275873249,47.4799107142857
9758297555.jpg,1,18,59,24,0,102,3.03921568627451,0.673715405841618,54.2087155963303
9264744599.jpg,0,10,57,33,1,101,3.24752475247525,0.638841773744632,64.1526548672566
5895477446.jpg,0,0,24,73,6,103,3.8252427184466,0.513106350364809,75.775
4743492963.jpg,0,46,51,3,0,100,2.57,0.555141259664437,40.8876146788991
4299510764.jpg,0,0,53,49,2,104,3.50961538461538,0.539600576976746,67.8761061946903
9439902792.jpg,0,2,33,64,2,101,3.65346534653465,0.555619358272486,75.9571428571429
6927744497.jpg,0,0,11,80,10,101,3.99009900990099,0.458149528100826,81.85
5076506.jpg,0,3,30,67,7,107,3.72897196261682,0.622988740592157,73.3088235294118
4376675146.jpg,8,49,43,4,0,104,2.41346153846154,0.691285237843067,38.6169724770642
7569119428.jpg,1,4,42,50,10,107,3.5981308411215,0.750594897198368,68.58125
3965556653.jpg,0,18,65,23,1,107,3.06542056074766,0.648234584218584,57.25
5720139957.jpg,0,17,66,19,0,102,3.01960784313725,0.596697049969938,54.3014705882353
6272882973.jpg,0,23,110,15,1,149,2.95973154362416,0.531179140023,53.8846153846154
6102774302.jpg,0,10,74,26,0,110,3.14545454545455,0.555809412856166,58.1260504201681
6800703361.jpg,0,1,45,59,2,107,3.57943925233645,0.550083753101153,70.5357142857143
5561303733.jpg,8,56,41,0,0,105,2.31428571428571,0.609449400220044,34.8561320754717
11054955216.jpg,5,53,48,0,0,106,2.40566037735849,0.581922951646685,36.75
7999779242.jpg,0,0,48,58,1,107,3.5607476635514,0.51720530016433,69.475
7924366.jpg,70,36,2,0,0,108,1.37037037037037,0.522263094664423,10.4978991596639
5153880006.jpg,0,0,38,59,1,98,3.62244897959184,0.507983807730595,74.9357142857143
5107763844.jpg,0,5,56,44,0,105,3.37142857142857,0.576079970028582,65.3823529411765
8088110789.jpg,0,0,19,70,11,100,3.92,0.544578420951158,78.7967289719626
7166012405.jpg,0,12,71,23,1,107,3.1214953271028,0.594158361042598,58.4527027027027
9710495757.jpg,0,1,24,70,8,103,3.8252427184466,0.567540004049458,80.7242990654206
7173197243.jpg,0,0,27,81,1,109,3.76146788990826,0.449260350337442,75.3886554621849
435823507.jpg,0,1,46,57,0,104,3.53846153846154,0.519952890380548,68.0760869565217
8159044184.jpg,0,12,47,44,3,106,3.35849056603774,0.71963852361589,63.3092105263158
3261536707.jpg,4,71,26,1,0,102,2.23529411764706,0.529832228036428,31.8663793103448
6437207759.jpg,0,1,27,75,3,106,3.75471698113208,0.512906206123813,74.5133928571429
6256829619.jpg,0,0,32,92,5,129,3.7906976744186,0.494886644291068,78.6507633587786
2780719978.jpg,0,9,88,28,1,126,3.16666666666667,0.547722557505166,59.9842519685039
6183915148.jpg,3,60,40,2,0,105,2.39047619047619,0.58004041794248,36.0067567567568
2489209226.jpg,0,17,72,14,0,103,2.97087378640777,0.550513319808434,54.8805309734513
10787038944.jpg,0,9,60,35,0,104,3.25,0.603388490031847,60.4978813559322
23371433.jpg,3,44,45,11,1,104,2.64423076923077,0.749346242326418,43.5192307692308
8539554428.jpg,0,1,43,63,1,108,3.59259259259259,0.530156687066959,70.4314159292035
5298580335.jpg,1,27,68,7,0,103,2.78640776699029,0.571384377285334,47.107476635514
10631219374.jpg,0,4,42,61,1,108,3.5462962962963,0.586200489757354,71.7142857142857
1316239068.jpg,0,5,62,37,0,104,3.30769230769231,0.558724676052145,61.6165254237288
8136167992.jpg,0,7,64,36,0,107,3.27102803738318,0.575770090678299,63.2219626168224
18238731.jpg,24,75,5,0,0,104,1.81730769230769,0.497848245231476,21.1666666666667
7505379000.jpg,1,18,56,30,0,105,3.0952380952381,0.70060152072522,55.0128205128205
7748906306.jpg,0,3,49,54,1,107,3.49532710280374,0.572545322844697,70.2383177570093
381148704.jpg,0,17,67,20,0,104,3.02884615384615,0.598651085134435,57.4430693069307
6251689254.jpg,0,34,67,1,0,102,2.67647058823529,0.490741300359832,44.425
9362014571.jpg,3,36,51,10,1,101,2.7029702970297,0.728622734416729,45.4782608695652
8207139364.jpg,0,31,62,9,0,102,2.7843137254902,0.590811674948363,46.1857798165138
7570426860.jpg,0,0,36,65,6,107,3.7196261682243,0.562916806135257,73.0127118644068
10866561184.jpg,0,0,19,81,5,105,3.86666666666667,0.461324736840019,77.3304347826087
7365538478.jpg,0,0,31,69,3,103,3.72815533980583,0.508634750057745,75.0290178571429
9016164225.jpg,0,0,47,56,3,106,3.58490566037736,0.549769207478433,69.5826086956522
5436025882.jpg,0,3,51,49,2,105,3.47619047619048,0.589902829273897,65.025641025641
6617738113.jpg,2,29,81,15,1,128,2.875,0.652071200401997,50.6309523809524
8529705971.jpg,0,0,28,73,2,103,3.74757281553398,0.479346912771086,75.7610619469027
5235250770.jpg,0,4,50,50,1,105,3.45714285714286,0.588815163445454,65.8950892857143
5564762599.jpg,0,0,21,82,5,108,3.85185185185185,0.46993367626719,77.7323008849557
5966778623.jpg,4,59,35,2,0,100,2.35,0.592461054424762,36.25
9249859612.jpg,0,2,55,45,0,102,3.42156862745098,0.534665149393819,67.9082568807339
298392087.jpg,0,1,59,41,0,101,3.3960396039604,0.511452987493319,64.2242990654206
7004286982.jpg,0,1,36,85,5,127,3.74015748031496,0.537669846552709,77.7116935483871
4167140049.jpg,0,6,63,30,1,100,3.26,0.579445921340012,60.1123853211009
9175070760.jpg,0,7,78,23,0,108,3.14814814814815,0.50815434432866,59.4932432432432
10186832194.jpg,1,14,54,28,4,101,3.1980198019802,0.761837278953951,57.5818584070796
8021353022.jpg,0,0,31,70,4,105,3.74285714285714,0.519403715601092,74.9553571428571
3158018696.jpg,3,69,34,0,0,106,2.29245283018868,0.515788460368257,34.5546218487395
6305573914.jpg,0,12,79,15,0,106,3.02830188679245,0.506294609694721,53.7715517241379
8623527706.jpg,3,9,80,21,0,113,3.05309734513274,0.610045489589005,54.0961538461538
6052980564.jpg,0,5,37,61,5,108,3.61111111111111,0.653292642893341,68.7331932773109
4345842908.jpg,0,9,78,20,0,107,3.10280373831776,0.512753930451479,57.2767857142857
7163375274.jpg,0,1,46,55,3,105,3.57142857142857,0.569364403678193,70.1674107142857
6194607609.jpg,0,1,23,74,10,108,3.86111111111111,0.571247746200316,76.14375
5447010296.jpg,0,11,73,15,0,99,3.04040404040404,0.513475391759617,56.8276699029126
8428991513.jpg,9,70,26,1,0,106,2.17924528301887,0.582231664109591,31.1551724137931
7485150056.jpg,0,2,76,29,0,107,3.25233644859813,0.477680281958733,61.9
10009096245.jpg,0,0,21,75,13,109,3.92660550458716,0.556217750098803,77.24375
3680743288.jpg,3,68,34,1,0,106,2.31132075471698,0.540955196581007,34.6292372881356
7823939538.jpg,0,2,29,67,7,105,3.75238095238095,0.600976007151834,74.8913043478261
10689722684.jpg,0,0,19,82,7,108,3.88888888888889,0.480134975830314,76.14375
324220404.jpg,0,4,53,45,0,102,3.40196078431373,0.567429568562114,62.6100917431193
4222055381.jpg,0,6,73,21,0,100,3.15,0.5,57.0694444444444
5195745450.jpg,1,18,55,19,5,98,3.09183673469388,0.787619860868547,56.4036697247706
7605930400.jpg,0,2,39,65,1,107,3.60747663551402,0.545254127107898,73.6933962264151
5939994525.jpg,1,44,55,2,0,102,2.56862745098039,0.554188442797278,42.1776315789474
5481249377.jpg,1,71,35,3,0,110,2.36363636363636,0.554005808058726,36.2878151260504
8072879274.jpg,0,3,45,53,1,102,3.50980392156863,0.575835132469745,71.2345132743363
8481265200.jpg,0,0,38,65,2,105,3.65714285714286,0.515687954032345,70.3970588235294
2908299910.jpg,1,27,71,11,1,111,2.85585585585586,0.630250265541711,47.7021739130435
10344523015.jpg,1,21,71,15,0,108,2.92592592592593,0.606871919907349,52.5263157894737
6016351794.jpg,0,1,39,64,3,107,3.64485981308411,0.553757941271021,70.4258474576271
4357293162.jpg,0,2,43,65,1,111,3.58558558558559,0.547198957808492,71.4745762711864
7977665407.jpg,10,86,12,0,0,108,2.01851851851852,0.453057762434833,27.7605042016807
4360105019.jpg,11,115,24,0,0,150,2.08666666666667,0.476799546566756,29.4652317880795
4733042196.jpg,0,2,25,83,3,113,3.76991150442478,0.517701816367335,73.6282051282051
7614530994.jpg,0,0,14,81,8,103,3.94174757281553,0.460716465025955,79.4486607142857
3141860810.jpg,0,3,39,61,3,106,3.60377358490566,0.59648566474642,72.671875
4374263037.jpg,0,8,51,42,0,101,3.33663366336634,0.620922341726762,61.6964285714286
9102604497.jpg,0,50,52,3,0,105,2.55238095238095,0.554369919210997,41.8608490566038
4178645830.jpg,0,2,48,60,2,112,3.55357142857143,0.566946709513841,69.1673728813559
8471068172.jpg,1,7,66,38,1,113,3.27433628318584,0.63030303951211,60.724358974359
2726553628.jpg,0,2,71,34,0,107,3.29906542056075,0.499338303120032,64.4891304347826
4693844054.jpg,0,13,70,19,0,102,3.05882352941176,0.559765322322265,56.1527777777778
7355344734.jpg,0,0,13,90,6,109,3.93577981651376,0.414443610912138,76.2899159663866
3020768905.jpg,0,2,71,57,0,130,3.42307692307692,0.526291466029296,69.0137795275591
5866763424.jpg,0,2,53,68,2,125,3.56,0.559377534234663,73.320564516129
5068225832.jpg,0,16,111,10,0,137,2.95620437956204,0.435022195828019,54.5036764705882
10783395635.jpg,0,0,45,62,2,109,3.60550458715596,0.527368530639052,71.9915966386555
7144832397.jpg,0,5,48,53,1,107,3.46728971962617,0.603726743906886,68.6351351351351
8627391076.jpg,0,0,42,60,2,104,3.61538461538462,0.527085636410755,72.799504950495
8429377035.jpg,0,20,62,22,0,104,3.01923076923077,0.638273904602475,54.2754237288136
8177148898.jpg,0,4,71,24,2,101,3.23762376237624,0.550427376708048,61.6
6480739257.jpg,0,30,70,11,0,111,2.82882882882883,0.585799746638169,49.46875
4163479239.jpg,1,47,55,2,0,105,2.55238095238095,0.554369919210997,42.9034653465347
4996581735.jpg,0,0,13,82,15,110,4.01818181818182,0.506504810048403,78.6470588235294
7665609968.jpg,0,1,45,64,0,110,3.57272727272727,0.51507710136473,69.3881578947368
4889658118.jpg,0,2,40,53,1,96,3.55208333333333,0.559507145275228,71.7142857142857
6926235386.jpg,0,4,64,27,1,96,3.26041666666667,0.547622452860721,62.05
9724373732.jpg,1,6,51,45,2,105,3.39047619047619,0.672184127922924,65.8541666666667
8585320404.jpg,0,5,51,45,1,102,3.41176470588235,0.602847060001036,66.853982300885
3861673008.jpg,4,64,29,0,0,97,2.25773195876289,0.525958460722421,32.7184466019417
4047658369.jpg,0,6,54,35,1,96,3.32291666666667,0.606886647990193,64.8
7179446780.jpg,0,2,54,49,0,105,3.44761904761905,0.536745040121693,69.0220588235294
8905578199.jpg,0,0,27,70,6,103,3.79611650485437,0.53061605522096,77.1482300884956
2519235976.jpg,8,76,21,0,0,105,2.12380952380952,0.513195833352107,31.2766990291262
9416795305.jpg,0,2,33,68,3,106,3.67924528301887,0.561412670753253,74.3173913043478
3638870308.jpg,0,9,78,16,0,103,3.06796116504854,0.490340736317866,56.1285046728972
3719984050.jpg,0,8,56,41,0,105,3.31428571428571,0.609449400220044,63.1399082568807
8660939599.jpg,0,2,45,57,0,104,3.52884615384615,0.538908115251656,70.0841121495327
9586652263.jpg,0,1,30,75,1,107,3.71028037383178,0.495438547764685,74.9527027027027
3108925603.jpg,0,0,45,55,5,105,3.61904761904762,0.57814278880661,71.5337837837838
3973001148.jpg,3,56,44,3,0,106,2.44339622641509,0.602853353079302,38.1596638655462
8595244033.jpg,0,0,26,72,4,102,3.7843137254902,0.500048531909845,78.7638888888889
7241141390.jpg,30,70,11,1,0,112,1.84821428571429,0.618190055451351,22.2045454545455
8232391054.jpg,0,5,74,25,1,105,3.20952380952381,0.531602043450486,59.754347826087
6340836746.jpg,8,70,30,2,0,110,2.23636363636364,0.604680106910321,31.3986486486486
8517575081.jpg,0,0,23,81,4,108,3.82407407407407,0.470209810073959,77.3991596638655
9996001596.jpg,0,2,57,43,1,103,3.41747572815534,0.551722291692297,67.2190265486726
5627315065.jpg,0,0,26,83,2,111,3.78378378378378,0.45538006914116,73.8397435897436
5195283750.jpg,0,1,61,33,2,97,3.37113402061856,0.546191122472749,66.9191176470588
6110951544.jpg,0,3,14,70,13,100,3.93,0.623690547459154,77.0022123893805
7963365940.jpg,1,36,62,5,0,104,2.68269230769231,0.578991810008362,45.1703539823009
2851510265.jpg,0,5,66,31,0,102,3.25490196078431,0.53927480659291,63.1399082568807
9240392822.jpg,0,3,46,47,5,101,3.53465346534653,0.641316714824174,67.525
4926447658.jpg,0,6,71,23,0,100,3.17,0.513553671720273,59.9610091743119
8157117322.jpg,0,0,23,75,4,102,3.81372549019608,0.48195953482134,79.6305309734513
4306124216.jpg,25,66,15,0,0,106,1.90566037735849,0.609891510833298,23.0982142857143
5098219464.jpg,10,44,53,2,0,109,2.43119266055046,0.685389487499818,39.0609243697479
87511338.jpg,4,78,23,1,0,106,2.19811320754717,0.505584269661014,32.9
9669015372.jpg,0,5,78,43,0,126,3.3015873015873,0.540663906986087,64.822
8650041199.jpg,0,1,24,81,5,111,3.81081081081081,0.51369452389729,74.5508474576271
4253075090.jpg,0,0,31,75,4,110,3.75454545454545,0.510196285961106,72.1995798319328
4894150529.jpg,0,2,34,61,2,99,3.63636363636364,0.561603852219212,76.0432692307692
10362672006.jpg,0,1,19,81,3,104,3.82692307692308,0.471360511593271,75.8189655172414
7249502132.jpg,0,3,50,43,2,98,3.44897959183673,0.594171848160297,67.3855140186916
8639759293.jpg,0,1,39,60,2,102,3.61764705882353,0.54580520311164,72.325
8391854291.jpg,0,24,76,5,0,105,2.81904761904762,0.495769649925795,49.0775862068966
2325353113.jpg,52,49,6,0,0,107,1.57009345794393,0.600505283038207,14.5882352941176
8121860471.jpg,0,2,56,45,3,106,3.4622641509434,0.588371898941911,66.2373949579832
3112828024.jpg,0,6,69,31,2,108,3.26851851851852,0.58973273657517,63.6697247706422
6214101646.jpg,0,7,77,22,1,107,3.1588785046729,0.534640290117207,60.3108108108108
9814999.jpg,0,38,53,16,0,107,2.79439252336449,0.683198882022214,47.796218487395
3178679066.jpg,0,0,24,81,6,111,3.83783783783784,0.496177031100439,79.5172413793103
8867729088.jpg,0,2,56,47,1,106,3.44339622641509,0.553434104637671,67.0
4537863241.jpg,0,9,73,26,0,108,3.15740740740741,0.549630921823901,60.1378504672897
3618474326.jpg,0,7,40,55,1,103,3.48543689320388,0.639608913442393,69.0810810810811
4313852687.jpg,0,0,40,64,3,107,3.65420560747664,0.53381510010521,70.327731092437
8451439208.jpg,0,0,50,52,2,104,3.53846153846154,0.538301480532277,66.9256756756757
5889219072.jpg,0,1,53,46,2,102,3.48039215686275,0.55811550238036,68.3871681415929
6264153932.jpg,3,43,51,0,0,97,2.49484536082474,0.561317485553077,40.6605504587156
8872523602.jpg,0,2,57,45,0,104,3.41346153846154,0.53263545017037,68.4513888888889
8116678978.jpg,0,0,21,78,4,103,3.83495145631068,0.466465377708571,78.5353982300885
7561653238.jpg,0,1,39,57,4,101,3.63366336633663,0.578321230411399,71.4305555555556
7342857520.jpg,0,20,61,15,1,97,2.96907216494845,0.636618806786792,51.9121621621622
5921674068.jpg,0,1,70,33,1,105,3.32380952380952,0.509434794182543,62.7327586206897
6815460393.jpg,0,10,65,27,0,102,3.16666666666667,0.581621722757015,57.9789719626168
4047293612.jpg,0,1,60,45,1,107,3.42990654205607,0.533980240124661,68.3141592920354
4617747913.jpg,1,33,62,8,0,104,2.74038461538462,0.607320908240659,48.0691964285714
3071201670.jpg,0,32,57,12,0,101,2.8019801980198,0.632768551370847,49.675
3312331811.jpg,31,66,4,0,0,101,1.73267326732673,0.527088021281283,18.9601769911504
7194253160.jpg,0,0,33,73,1,107,3.70093457943925,0.480073761451812,76.2162162162162
5189469288.jpg,9,76,36,0,0,121,2.22314049586777,0.569906473405727,32.5317796610169
7975750167.jpg,0,0,50,55,2,107,3.55140186915888,0.536122431451909,71.640625
5887175840.jpg,10,57,37,1,0,105,2.27619047619048,0.642938537785661,34.4459459459459
10004473376.jpg,0,0,25,73,7,105,3.82857142857143,0.527277894493955,77.3836206896552
8354332729.jpg,0,19,77,10,0,106,2.91509433962264,0.518568074757916,53.1052631578947
11333447674.jpg,0,0,21,82,6,109,3.86238532110092,0.480506867956021,76.9978813559322
10828147985.jpg,1,15,76,16,0,108,2.99074074074074,0.571853362851923,54.1184210526316
9760551223.jpg,0,1,45,56,5,107,3.60747663551402,0.594899854356262,69.6344537815126
45917867.jpg,16,79,8,0,0,103,1.92233009708738,0.478750833477993,23.0474137931034
5573453953.jpg,1,19,63,22,0,105,3.00952380952381,0.657723903017621,55.9495412844037
5551470289.jpg,0,9,78,19,0,106,3.09433962264151,0.507623818098411,57.925
11118140253.jpg,0,0,45,55,4,104,3.60576923076923,0.56462495896549,72.8235294117647
4367292033.jpg,0,7,70,29,0,106,3.20754716981132,0.547148123621374,58.8223684210526
3162134277.jpg,18,70,18,1,0,107,2.01869158878505,0.614007995941036,27.4485294117647
4822674187.jpg,0,11,96,10,0,117,2.99145299145299,0.425394877320422,55.6474358974359
9588413178.jpg,0,2,38,57,0,97,3.56701030927835,0.538269149195776,73.6933962264151
6918766149.jpg,0,11,70,23,0,104,3.11538461538462,0.562720374224038,55.225
8731705218.jpg,0,0,32,69,6,107,3.75700934579439,0.546707494751528,73.031512605042
10335072144.jpg,0,16,49,42,0,107,3.24299065420561,0.698260932675251,62.1610576923077
3011247965.jpg,2,23,46,34,0,105,3.06666666666667,0.787726361443376,55.2567567567568
8732646741.jpg,0,17,73,18,0,108,3.00925925925926,0.571853362851923,54.313025210084
7557808298.jpg,0,0,29,72,1,102,3.72549019607843,0.470029759856178,75.7610619469027
8544556866.jpg,0,1,63,45,0,109,3.40366972477064,0.511339309957935,65.453125
3853359984.jpg,0,7,57,31,2,97,3.28865979381443,0.628469750110635,61.4471153846154
8866395362.jpg,0,5,48,49,2,104,3.46153846153846,0.62197738108714,69.6691176470588
6233367790.jpg,1,6,71,27,0,105,3.18095238095238,0.568076247268466,60.6422018348624
9191266611.jpg,0,3,40,59,2,104,3.57692307692308,0.586122815790719,70.6586956521739
3102411945.jpg,2,9,69,19,0,99,3.06060606060606,0.603022689155527,56.275
8321029602.jpg,0,5,71,28,0,104,3.22115384615385,0.520580907214179,61.2027027027027
5166736586.jpg,0,1,22,77,11,111,3.88288288288288,0.567910664209189,79.2692307692308
11438612393.jpg,10,58,29,1,0,98,2.21428571428571,0.630005727350828,31.9953271028037
2649433967.jpg,9,68,28,2,0,107,2.21495327102804,0.614725546724555,33.1160714285714
4996914779.jpg,0,20,65,14,1,100,2.96,0.618241233033047,52.525
4495630749.jpg,0,1,22,83,4,110,3.81818181818182,0.491800999917243,76.35
6890677809.jpg,0,0,14,75,12,101,3.98019801980198,0.509513454578031,80.05
2191619969.jpg,0,8,74,21,0,103,3.12621359223301,0.517907018123218,59.575
268066639.jpg,0,13,83,12,0,108,2.99074074074074,0.483278723595215,54.1666666666667
2298149104.jpg,1,6,51,44,0,102,3.35294117647059,0.639415866217659,63.0306603773585
8737972385.jpg,0,1,48,50,3,102,3.53921568627451,0.574569466497057,68.5277777777778
8611793668.jpg,0,1,58,50,2,111,3.47747747747748,0.55344946138406,68.2692307692308
3051623040.jpg,2,28,69,5,0,104,2.74038461538462,0.57445951478755,48.7266355140187
4428546636.jpg,0,23,91,11,0,125,2.904,0.514687503060305,53.3170731707317
2806740564.jpg,0,2,44,58,3,107,3.57943925233645,0.583376366064357,72.5245535714286
7924068268.jpg,0,2,35,58,10,105,3.72380952380952,0.657723903017621,73.2586206896552
2333476039.jpg,27,70,8,0,0,105,1.81904761904762,0.550890055709716,20.9137931034483
6513274589.jpg,0,8,70,31,0,109,3.21100917431193,0.562293492881853,59.6261061946903
6489144861.jpg,0,4,50,52,0,106,3.45283018867925,0.571248848646511,66.9256756756757
8530273249.jpg,0,10,68,23,0,101,3.12871287128713,0.55970289148143,57.8160377358491
5628498882.jpg,0,2,40,58,2,102,3.58823529411765,0.569052385423217,69.972972972973
1063351510.jpg,0,37,63,9,0,109,2.74311926605505,0.599439085416844,47.1153846153846
7369682094.jpg,0,3,69,33,0,105,3.28571428571429,0.513552591013095,60.7586956521739
6929188980.jpg,0,5,40,61,1,107,3.54205607476635,0.603142303553142,70.8648648648649
6561794905.jpg,0,5,57,47,1,110,3.4,0.593543240195398,65.3794642857143
6617069623.jpg,3,71,30,1,0,105,2.27619047619048,0.527972138237027,33.6413043478261
8266041849.jpg,0,2,42,55,4,103,3.59223300970874,0.601255112144644,68.1785714285714
6725311751.jpg,0,10,67,30,0,107,3.18691588785047,0.584885751164282,58.972972972973
3898078585.jpg,35,70,7,0,0,112,1.75,0.561529442963871,19.9679487179487
4297818651.jpg,3,62,67,2,0,134,2.50746268656716,0.571849244773144,41.25
6160450342.jpg,5,52,45,4,0,106,2.45283018867925,0.649279094317736,37.4849137931034
10745932825.jpg,0,4,51,50,1,106,3.45283018867925,0.587684325235566,64.8846153846154
6884968602.jpg,3,69,37,1,0,110,2.32727272727273,0.543672373500889,36.2372881355932
5848411050.jpg,0,1,25,65,13,104,3.86538461538462,0.624075118513327,79.4121621621622
5422446412.jpg,0,1,27,75,3,106,3.75471698113208,0.512906206123813,78.5647321428571
6940429128.jpg,2,53,45,1,0,101,2.44554455445545,0.556331691075611,40.225
302681636.jpg,0,17,70,24,0,111,3.06306306306306,0.607218386343965,53.5762711864407
5402777838.jpg,8,73,22,0,0,103,2.13592233009709,0.524844396909281,30.7297297297297
2367261033.jpg,38,58,12,0,0,108,1.75925925925926,0.639368414562084,18.3175675675676
3806051518.jpg,44,50,6,0,0,100,1.62,0.599326221011495,15.7591743119266
3358754066.jpg,3,48,52,3,0,106,2.5188679245283,0.605233242335575,40.7434782608696
2324511288.jpg,4,54,40,4,0,102,2.43137254901961,0.637287008435109,37.1393805309735
9339023066.jpg,0,0,43,63,1,107,3.60747663551402,0.509476411693017,72.0285714285714
1026198859.jpg,0,2,40,61,1,104,3.58653846153846,0.550561530172921,70.2715517241379
8194417466.jpg,0,0,17,82,9,108,3.92592592592593,0.487290884048434,80.8243243243243
5257312652.jpg,0,1,18,80,4,103,3.84466019417476,0.480140534030996,78.9428571428571
5209744209.jpg,2,15,87,23,0,127,3.03149606299213,0.603389998312652,56.8511904761905
5104334034.jpg,0,3,44,54,0,101,3.5049504950495,0.558994854649622,68.375
8593005656.jpg,2,23,74,9,0,108,2.83333333333333,0.588042849223902,49.984375
5122027937.jpg,0,4,54,47,2,107,3.4392523364486,0.601532164692449,67.3716216216216
7176672187.jpg,0,7,75,28,0,110,3.19090909090909,0.533216904166657,59.3392857142857
8512098446.jpg,0,13,70,24,0,107,3.10280373831776,0.581711518973664,56.61875
5166185394.jpg,0,4,67,31,1,103,3.28155339805825,0.549821285191929,62.8
5885686436.jpg,0,1,43,65,1,110,3.6,0.528108968460873,71.1949152542373
8412460969.jpg,6,56,45,2,0,109,2.39449541284404,0.623881942533605,38.3421052631579
7250719968.jpg,0,0,27,77,2,106,3.76415094339623,0.469079885418106,76.4514563106796
8320909145.jpg,0,9,58,34,1,102,3.26470588235294,0.628158877995575,60.4908256880734
4890086996.jpg,0,4,76,28,0,108,3.22222222222222,0.499220576299318,59.9911504424779
4582906874.jpg,1,21,61,18,0,101,2.95049504950495,0.653853769948027,54.85
3850577376.jpg,0,44,56,5,0,105,2.62857142857143,0.576079970028582,44.0434782608696
4837286609.jpg,0,0,22,77,5,104,3.83653846153846,0.484929720122209,76.885775862069
8044706176.jpg,1,60,46,2,0,109,2.44954128440367,0.552540237048483,39.0769230769231
7054855385.jpg,1,51,51,1,0,104,2.5,0.539687072220866,38.640625
8343118972.jpg,0,1,25,67,12,105,3.85714285714286,0.611249845502127,74.3581081081081
4263025475.jpg,0,3,28,65,8,104,3.75,0.634753984910078,72.277027027027
7994058325.jpg,1,20,61,16,0,98,2.93877551020408,0.639205797984946,50.8855140186916
8064104833.jpg,0,5,55,44,0,104,3.375,0.577700496864656,66.8526785714286
7911339166.jpg,0,1,34,66,3,104,3.68269230769231,0.544423148479607,72.2629310344828
10017119924.jpg,0,3,58,50,0,111,3.42342342342342,0.548544347250886,66.224358974359
5037503230.jpg,0,4,71,32,0,107,3.26168224299065,0.520095212584592,61.9390756302521
9477685137.jpg,0,3,54,50,0,107,3.4392523364486,0.552482734186941,66.1160714285714
3311728409.jpg,0,0,30,77,3,110,3.75454545454545,0.491885785884585,75.4615384615385
9737673243.jpg,0,11,70,18,0,99,3.07070707070707,0.539321668669481,58.0291262135922
6253185409.jpg,0,34,71,3,0,108,2.71296296296296,0.512478418527609,47.0986842105263
11404463006.jpg,0,13,79,12,0,104,2.99038461538462,0.492569886770648,54.1504424778761
5064176245.jpg,0,0,25,68,10,103,3.85436893203884,0.567204479335504,75.1756756756757
4551121129.jpg,0,0,13,84,9,106,3.9622641509434,0.456164721750019,80.9173913043478
8484679828.jpg,0,1,40,64,5,110,3.66363636363636,0.579105173811527,68.925
5899300375.jpg,1,57,38,6,0,102,2.48039215686275,0.625060664887306,39.925
6265723593.jpg,0,0,46,56,0,102,3.54901960784314,0.500048531909845,72.6216814159292
7376214050.jpg,2,54,41,3,0,100,2.45,0.592461054424762,38.1635514018692
5362095529.jpg,0,2,25,69,6,102,3.77450980392157,0.578609852395438,75.3986486486486
9249272493.jpg,0,1,18,92,3,114,3.85087719298246,0.445875019997238,76.1108695652174
7883125264.jpg,3,41,44,14,0,102,2.67647058823529,0.746765496690343,45.4410377358491
4597162839.jpg,0,0,28,72,2,102,3.74509803921569,0.481052363502936,74.7297297297297
3456840631.jpg,0,0,39,97,2,138,3.73188405797101,0.476297384139528,76.8214285714286
8090282985.jpg,1,44,84,1,0,130,2.65384615384615,0.509012396272169,44.8125
9648319367.jpg,0,2,48,54,0,104,3.5,0.539687072220866,69.9926470588235
8218739759.jpg,0,4,67,72,2,145,3.49655172413793,0.578841490621023,71.0684931506849
9324716054.jpg,0,2,29,70,3,104,3.71153846153846,0.551662569637779,74.4642857142857
8468581524.jpg,1,10,57,42,0,110,3.27272727272727,0.662343502846624,61.3783185840708
8771756230.jpg,25,68,9,0,0,102,1.84313725490196,0.55837632434446,22.1725663716814
8732282616.jpg,0,5,54,42,0,101,3.36633663366337,0.578321230411399,66.8413461538462
5153889058.jpg,0,2,62,48,2,114,3.43859649122807,0.564982382359804,65.3076923076923
4195621541.jpg,0,14,73,21,0,108,3.06481481481481,0.568209980736327,55.4210526315789
5789601551.jpg,1,21,69,18,0,109,2.95412844036697,0.62930474718677,53.5663716814159
7169652147.jpg,0,3,64,43,1,111,3.37837837837838,0.556842625948939,64.9189189189189
9346372358.jpg,0,2,36,60,10,108,3.72222222222222,0.653292642893341,74.8080357142857
149867784.jpg,0,3,29,59,7,98,3.71428571428571,0.642161299067936,72.8928571428571
5113314470.jpg,0,10,74,17,0,101,3.06930693069307,0.514925737219927,55.75
2293775114.jpg,3,40,58,9,0,110,2.66363636363636,0.667423812471915,43.6483050847458
5103528737.jpg,11,62,29,2,0,104,2.21153846153846,0.648719080271491,33.1897321428571
3305968848.jpg,21,74,9,0,0,104,1.88461538461538,0.527085636410755,23.7064220183486
10082923485.jpg,0,16,77,11,0,104,2.95192307692308,0.509707848784743,53.2260869565217
5269333343.jpg,0,0,22,76,4,102,3.82352941176471,0.475368844930275,79.15
5884745280.jpg,3,38,55,6,0,102,2.62745098039216,0.643652458763498,45.608407079646
5091924028.jpg,14,66,16,0,0,96,2.02083333333333,0.561561107265258,25.8308823529412
7217797182.jpg,0,4,71,32,0,107,3.26168224299065,0.520095212584592,63.3419811320755
4681329966.jpg,0,6,38,57,9,110,3.62727272727273,0.714965719446268,72.5
6766779583.jpg,0,4,49,60,0,113,3.49557522123894,0.568894507627822,66.4260869565217
3243513416.jpg,1,17,55,26,2,101,3.10891089108911,0.733498331272947,55.0195652173913
6011182310.jpg,13,72,23,3,0,111,2.14414414414414,0.644513161539169,30.4955752212389
6310649828.jpg,30,70,5,0,0,105,1.76190476190476,0.528492222557749,18.7522321428571
2322493147.jpg,0,5,35,60,1,101,3.56435643564356,0.606891120122191,68.0951327433628
11410644126.jpg,0,7,59,41,0,107,3.31775700934579,0.592374990253441,63.6282608695652
5457535055.jpg,0,3,63,41,0,107,3.35514018691589,0.536451240088433,64.3986486486486
5062330348.jpg,0,1,58,46,1,106,3.44339622641509,0.535949334478999,68.2195652173913
8179614383.jpg,0,8,81,21,0,110,3.11818181818182,0.501956140154561,57.6923076923077
9290273110.jpg,1,25,68,11,0,105,2.84761904761905,0.600976007151834,47.921875
5602088551.jpg,0,2,57,50,2,111,3.46846846846847,0.569207101147486,67.2115384615385
9712984770.jpg,0,7,72,26,1,106,3.19811320754717,0.559247986917716,59.4491525423729
8096129179.jpg,0,1,29,67,3,100,3.72,0.533333333333333,73.3577981651376
7553660370.jpg,0,13,66,31,0,110,3.16363636363636,0.613715900075111,56.6701680672269
8607324496.jpg,0,32,60,13,0,105,2.81904761904762,0.632165879839856,50.3398058252427
8658742127.jpg,0,3,21,76,5,105,3.79047619047619,0.566623570867177,74.2543103448276
10516786036.jpg,0,1,28,69,11,109,3.8256880733945,0.606203069160939,73.94375
450789020.jpg,0,31,66,7,0,104,2.76923076923077,0.561391634768236,49.6824324324324
4699352200.jpg,0,2,42,62,1,107,3.57943925233645,0.550083753101153,71.9345794392523
3467784087.jpg,0,0,54,52,0,106,3.49056603773585,0.502285879874493,69.925
7903006270.jpg,0,1,27,66,12,106,3.83962264150943,0.619320556321587,76.0126050420168
2529798721.jpg,1,45,51,6,1,104,2.625,0.656372792487963,44.2942477876106
4922576334.jpg,0,2,55,48,3,108,3.48148148148148,0.587748459794076,68.4601769911504
9438332547.jpg,0,0,16,86,2,104,3.86538461538462,0.395550306294357,78.6217391304348
2953741163.jpg,2,42,55,10,0,109,2.6697247706422,0.667430754787558,45.1864406779661
11554709013.jpg,0,0,43,55,1,99,3.57575757575758,0.516876590704738,68.7733644859813
10115071674.jpg,0,2,34,64,9,109,3.73394495412844,0.633073072765233,72.775
6216628901.jpg,0,1,21,70,9,101,3.86138613861386,0.566210260774158,81.85
9018209858.jpg,1,47,58,5,0,111,2.6036036036036,0.592057725675758,43.4487179487179
5385761239.jpg,0,29,60,10,1,100,2.83,0.636515133481927,48.9862385321101
7756578200.jpg,39,61,9,0,0,109,1.72477064220183,0.606623313973396,18.3030973451327
5121622263.jpg,0,0,31,78,2,111,3.73873873873874,0.480751527425583,71.614406779661
434815119.jpg,19,77,9,0,0,105,1.9047619047619,0.509973783711732,22.9521739130435
3416752031.jpg,0,3,52,52,1,108,3.47222222222222,0.571247746200316,68.533185840708
10372323314.jpg,0,0,64,44,1,109,3.42201834862385,0.51448604310428,65.3361344537815
8601680123.jpg,0,23,62,16,0,101,2.93069306930693,0.620603347438189,53.25
6237039351.jpg,0,2,43,61,0,106,3.55660377358491,0.535949334478999,73.3042452830189
6688716327.jpg,0,1,26,73,4,104,3.76923076923077,0.525666829970697,75.5584112149533
9253116202.jpg,0,0,38,67,3,108,3.67592592592593,0.526471302014582,74.4716981132076
6938775083.jpg,0,29,68,5,0,102,2.76470588235294,0.529832228036428,50.0619469026549
3994759280.jpg,0,5,58,43,1,107,3.37383177570093,0.59118308765705,66.4602803738318
5247748944.jpg,2,27,61,19,0,109,2.88990825688073,0.698403596853466,51.8865546218487
3462395913.jpg,0,29,72,5,0,106,2.77358490566038,0.521591317264946,49.5424107142857
6046933267.jpg,0,1,23,81,5,110,3.81818181818182,0.510114543384925,77.0833333333333
5212639990.jpg,0,3,64,32,0,99,3.29292929292929,0.520057399746535,60.4908256880734
5199036142.jpg,10,74,24,2,0,110,2.16363636363636,0.598580472578076,31.04375
6748739885.jpg,2,31,66,10,0,109,2.77064220183486,0.63293887603394,47.1029411764706
11302087114.jpg,0,4,45,55,6,110,3.57272727272727,0.656080814404133,65.5441176470588
3273769271.jpg,0,2,35,63,3,103,3.6504854368932,0.572383010806878,70.195945945946
562942809.jpg,42,70,14,1,0,127,1.79527559055118,0.658745593366971,21.2027559055118
8528934790.jpg,0,0,43,63,1,107,3.60747663551402,0.509476411693017,72.7894736842105
143899204.jpg,4,36,56,10,0,106,2.67924528301887,0.697576345865362,44.8625
2848415190.jpg,0,2,43,57,2,104,3.56730769230769,0.57054603512134,72.6486486486486
4615199637.jpg,4,64,34,1,0,103,2.31067961165049,0.560621612518976,35.1565420560748
4268587808.jpg,1,5,56,42,2,106,3.36792452830189,0.652109714667755,66.019801980198
6576363795.jpg,16,59,23,5,0,103,2.16504854368932,0.742242064244632,31.7640186915888
8661391867.jpg,2,11,71,25,0,109,3.09174311926605,0.631595340500571,54.41875
4321538602.jpg,0,1,54,46,0,101,3.44554455445545,0.519138662107774,64.8478260869565
49874259.jpg,0,9,54,45,1,109,3.34862385321101,0.643718174891012,62.4318181818182
6818698150.jpg,0,6,56,36,1,99,3.32323232323232,0.603193589736868,64.25
9212037816.jpg,0,8,34,57,6,105,3.58095238095238,0.717647765284833,71.2013888888889
4298923773.jpg,0,22,69,12,0,103,2.90291262135922,0.569047417073793,54.0044247787611
8642082647.jpg,7,58,29,3,0,97,2.28865979381443,0.644831419936604,32.535046728972
9028566654.jpg,0,1,41,56,2,100,3.59,0.552222323842033,71.0114678899083
8645856155.jpg,0,3,74,34,0,111,3.27927927927928,0.50759989918996,64.8141025641026
1573719804.jpg,0,2,38,69,2,111,3.63963963963964,0.552560861194046,72.5
7036262065.jpg,0,0,44,60,1,105,3.59047619047619,0.513195833352107,71.7763157894737
4288180189.jpg,0,27,62,15,0,104,2.88461538461538,0.627952325005221,50.5717391304348
9806684784.jpg,0,1,63,41,0,105,3.38095238095238,0.507273109208449,64.3243243243243
8442013836.jpg,1,41,82,7,0,131,2.72519083969466,0.569121254006207,46.7843511450382
8033437927.jpg,1,5,60,32,2,100,3.29,0.640312423743285,63.4
5993929800.jpg,0,0,6,97,7,110,4.00909090909091,0.345228405856435,79.9642857142857
2144963177.jpg,0,5,72,29,0,106,3.22641509433962,0.521591317264946,60.296875
9408400121.jpg,0,1,45,64,4,114,3.62280701754386,0.57051988210712,71.5756302521008
6731073163.jpg,0,3,51,49,1,104,3.46153846153846,0.573239422405291,65.6602564102564
6131345309.jpg,0,0,41,60,2,103,3.62135922330097,0.526112357610771,69.5108695652174
2974085281.jpg,1,52,62,3,0,118,2.56779661016949,0.562029496432532,42.9551282051282
494236256.jpg,0,54,44,2,0,100,2.48,0.54085603678359,38.6926605504587
8016790601.jpg,0,7,61,53,4,125,3.432,0.651747031867723,68.609756097561
6870596537.jpg,0,13,69,20,0,102,3.06862745098039,0.567429568562114,56.9084821428571
6210494281.jpg,0,7,72,27,1,107,3.20560747663551,0.561976259436275,59.7075892857143
8209647019.jpg,0,0,27,71,7,105,3.80952380952381,0.538788493096354,75.1052631578947
2670033779.jpg,2,8,85,12,0,107,3.0,0.513956168750047,55.0669642857143
5796436033.jpg,0,8,56,42,1,107,3.33644859813084,0.628624212574419,60.74375
11433127464.jpg,0,15,80,15,0,110,3.0,0.524623062587002,54.109375
3370823326.jpg,0,23,61,22,0,106,2.99056603773585,0.654585045132999,56.5401785714286
3252078614.jpg,1,28,71,10,0,110,2.81818181818182,0.593262139900117,47.81875
649761301.jpg,6,80,41,0,0,127,2.2755905511811,0.544484106409208,33.6071428571429
4548390935.jpg,0,0,33,69,1,103,3.68932038834951,0.485659571999109,76.1261061946903
10790803694.jpg,0,3,46,90,1,140,3.63571428571429,0.539260275190716,73.8564189189189
7992243526.jpg,18,71,22,0,0,111,2.03603603603604,0.601935181166513,26.8879310344828
4497186913.jpg,1,19,82,7,0,109,2.87155963302752,0.511006947680403,51.0110619469027
5129204001.jpg,0,15,69,15,0,99,3.0,0.553283335172488,54.9655963302752
8231125615.jpg,0,8,56,40,2,106,3.33962264150943,0.64567118939582,61.9504310344828
9859562873.jpg,3,61,37,0,0,101,2.33663366336634,0.534363691183678,36.2834821428571
5577299644.jpg,0,23,72,18,1,114,2.97368421052632,0.630500943074245,52.0065217391304
8567636458.jpg,1,18,61,32,0,112,3.10714285714286,0.689132407381539,55.0833333333333
5626243539.jpg,6,33,54,12,0,105,2.68571428571429,0.750823723477264,44.6592920353982
9034987420.jpg,36,67,2,0,0,105,1.67619047619048,0.509434794182543,17.6633663366337
6253829392.jpg,0,18,49,37,4,108,3.25,0.774898244751933,59.7125
10050349236.jpg,6,69,27,0,0,102,2.20588235294118,0.532846555181383,30.9418103448276
6904675638.jpg,0,41,57,2,0,100,2.61,0.529817959970281,43.0210280373832
6206641810.jpg,0,0,34,65,5,104,3.72115384615385,0.547841851767616,72.9867256637168
2861346409.jpg,0,6,54,40,2,102,3.37254901960784,0.628081608928551,62.5344036697248
3973813247.jpg,1,55,49,5,0,110,2.52727272727273,0.601360703388282,39.98125
4576647416.jpg,0,8,67,29,1,105,3.21904761904762,0.588037027565055,59.3445945945946
5363150332.jpg,2,19,56,24,1,102,3.02941176470588,0.737347162924021,55.2032710280374
10900020096.jpg,0,3,46,57,0,106,3.50943396226415,0.556267887140855,69.3783783783784
4688027801.jpg,0,18,56,29,0,103,3.10679611650485,0.670273888403067,58.75
3978837773.jpg,0,10,72,40,0,122,3.24590163934426,0.593511408397612,63.077868852459
5987384542.jpg,0,0,18,66,18,102,4.0,0.597022314125993,82.8188073394495
5393136028.jpg,0,18,72,14,0,104,2.96153846153846,0.556044925946993,55.140625
156015117.jpg,1,10,55,33,4,103,3.28155339805825,0.733210449528076,62.077731092437
8178464033.jpg,0,0,27,73,4,104,3.77884615384615,0.50158449460463,75.9129464285714
8073301888.jpg,0,3,59,44,0,106,3.38679245283019,0.544596918952884,64.7565789473684
6512960549.jpg,0,3,53,46,3,105,3.46666666666667,0.605530070819498,65.8620689655172
8604870622.jpg,0,1,28,72,4,105,3.75238095238095,0.533150151691889,75.3230088495575
2285789022.jpg,0,24,71,8,0,103,2.84466019417476,0.53792049768654,51.6
6272061393.jpg,0,1,25,74,5,105,3.79047619047619,0.531602043450486,73.6891891891892
9583278733.jpg,0,3,43,83,2,131,3.6412213740458,0.555652108788561,74.60546875
5831366691.jpg,0,8,71,28,1,108,3.2037037037037,0.576149955481303,59.025
2786566950.jpg,5,76,26,0,0,107,2.19626168224299,0.503558138451676,31.2268907563025
9549652790.jpg,0,0,27,78,7,112,3.82142857142857,0.523575471284966,74.5508474576271
9977191265.jpg,0,1,44,58,5,108,3.62037037037037,0.591490949877323,74.4716981132076
7493136824.jpg,7,72,24,1,0,104,2.18269230769231,0.553267839716467,31.7572815533981
3916915691.jpg,0,23,77,8,0,108,2.86111111111111,0.519855000152735,50.9583333333333
7838423662.jpg,0,2,58,45,3,108,3.4537037037037,0.586200489757354,65.9778761061947
4578563691.jpg,0,1,52,49,1,103,3.48543689320388,0.539863411736181,69.6517857142857
4418637804.jpg,1,5,41,59,1,107,3.50467289719626,0.649728996853956,70.1216216216216
8532727626.jpg,0,0,48,57,4,109,3.59633027522936,0.563048350911192,70.4663865546218
7846766204.jpg,0,0,24,84,0,108,3.77777777777778,0.417677900612944,76.4285714285714
3364722083.jpg,1,31,63,7,0,102,2.74509803921569,0.591796635357012,44.5334821428571
8568057395.jpg,0,7,78,24,0,109,3.15596330275229,0.512335103130853,59.3792372881356
9770742411.jpg,0,2,35,62,3,102,3.64705882352941,0.574146957824214,70.6
451764144.jpg,0,5,56,49,2,112,3.42857142857143,0.610925832839284,63.7139830508475
6523676619.jpg,1,5,75,19,1,101,3.13861386138614,0.548264588867401,56.4036697247706
9121896285.jpg,0,6,75,21,2,104,3.18269230769231,0.553267839716467,57.6351351351351
6036947560.jpg,0,0,21,79,3,103,3.8252427184466,0.45216655932624,78.5353982300885
4935990245.jpg,0,10,66,24,0,100,3.14,0.568890467169528,57.3621495327103
6153807982.jpg,0,3,44,56,0,103,3.51456310679612,0.557727842651489,66.7053571428571
5869591890.jpg,0,1,45,62,1,109,3.57798165137615,0.532178923922789,70.2860169491525
8158344434.jpg,0,1,40,63,1,105,3.60952380952381,0.527972138237027,72.4276315789474
5884690824.jpg,0,3,57,44,0,104,3.39423076923077,0.547159819941693,64.1526548672566
8610015449.jpg,0,1,49,51,0,101,3.4950495049505,0.521991616335696,69.775
5740000928.jpg,0,0,50,58,1,109,3.55045871559633,0.517941769430268,69.0105042016807
5884382109.jpg,0,4,73,33,0,110,3.26363636363636,0.518948703114017,63.1217948717949
322036819.jpg,5,64,36,1,0,106,2.31132075471698,0.575089352016914,36.2427184466019
3587076357.jpg,1,5,58,41,0,105,3.32380952380952,0.612297660381309,62.9108695652174
4411055719.jpg,18,74,13,0,0,105,1.95238095238095,0.543863535997355,24.1163366336634
5133576528.jpg,2,56,42,4,0,104,2.46153846153846,0.606166962854181,39.6037735849057
7934073070.jpg,1,24,93,11,0,129,2.88372093023256,0.539500738193775,53.0984251968504
6160448268.jpg,3,35,62,4,0,104,2.64423076923077,0.606089955045593,44.6808035714286
3653350159.jpg,0,2,42,89,2,135,3.67407407407407,0.530131349953412,76.3617021276596
3635405613.jpg,0,21,75,12,0,108,2.91666666666667,0.549000791583107,52.0608108108108
154603426.jpg,1,8,43,45,4,101,3.42574257425743,0.739547627316393,64.0
5578143578.jpg,0,1,55,84,2,142,3.61267605633803,0.530603718102097,72.4438775510204
9122758028.jpg,0,0,43,78,5,126,3.6984126984127,0.540663906986087,75.9153225806452
8221139072.jpg,0,0,42,65,2,109,3.63302752293578,0.521048630322929,72.6410256410256
4750521580.jpg,0,0,17,79,7,103,3.90291262135922,0.475158654758682,81.0408653846154
3511207085.jpg,0,1,43,66,0,110,3.59090909090909,0.512154193837384,70.8782051282051
6989772902.jpg,56,47,3,0,0,106,1.5,0.556348640264187,12.7457627118644
3770559253.jpg,0,12,74,12,0,98,3.0,0.497416003373807,55.1261682242991
7110105161.jpg,1,31,67,7,0,106,2.75471698113208,0.582463091080284,47.0986842105263
9605307671.jpg,0,3,49,54,1,107,3.49532710280374,0.572545322844697,68.6205357142857
5024762120.jpg,0,0,24,71,5,100,3.81,0.506423386569624,76.2162162162162
3510063780.jpg,5,31,58,11,0,105,2.71428571428571,0.716753977133203,46.0521739130435
6006544496.jpg,0,28,63,13,0,104,2.85576923076923,0.614047043369844,49.1973684210526
5114869072.jpg,0,0,34,69,3,106,3.70754716981132,0.515788460368257,74.5133928571429
6308697965.jpg,0,8,73,24,0,105,3.15238095238095,0.533150151691889,57.8965517241379
8195491375.jpg,1,28,59,15,1,104,2.875,0.692364739164868,50.651376146789
10683218616.jpg,0,2,41,68,1,112,3.60714285714286,0.542884236944945,69.4391304347826
5459231907.jpg,0,2,33,67,2,104,3.66346153846154,0.550561530172921,73.6
7906332480.jpg,0,2,57,41,1,101,3.40594059405941,0.550966747123312,65.2
322245825.jpg,0,7,73,22,0,102,3.14705882352941,0.515061446368524,58.5229357798165
5659520017.jpg,0,21,70,12,0,103,2.9126213592233,0.561978230624793,51.2710280373832
9923517944.jpg,1,18,63,31,0,113,3.09734513274336,0.6809211430365,55.1843220338983
7785216770.jpg,0,5,71,25,1,102,3.2156862745098,0.538193733390896,59.875
3159188052.jpg,0,57,54,2,0,113,2.51327433628319,0.536440721125756,40.7247899159664
9281657562.jpg,0,0,36,70,2,108,3.68518518518519,0.505079768811405,72.0089285714286
8556730555.jpg,0,12,60,23,1,96,3.13541666666667,0.626095531077397,58.518691588785
5756343761.jpg,0,1,30,74,5,110,3.75454545454545,0.544974768145213,75.7702702702703
11389330254.jpg,1,8,48,46,1,104,3.36538461538462,0.683476156467835,64.0535714285714
10690294454.jpg,0,2,37,70,0,109,3.62385321100917,0.523326093822681,72.5
3365417061.jpg,0,25,64,14,1,104,2.91346153846154,0.64024535532185,51.4326086956522
6177663697.jpg,0,2,45,62,2,111,3.57657657657658,0.564874073650685,68.5252100840336
5948128813.jpg,0,1,53,74,1,129,3.58139534883721,0.525857549903677,72.9548872180451
10415631353.jpg,1,49,52,7,0,109,2.59633027522936,0.625377901382745,43.0819327731092
10635160054.jpg,0,1,61,62,0,124,3.49193548387097,0.517906475876725,69.7049180327869
5514988242.jpg,0,8,77,44,0,129,3.27906976744186,0.572504696842722,62.5958646616541
4429141481.jpg,0,1,39,71,2,113,3.65486725663717,0.530665207620599,71.8529411764706
8351568109.jpg,0,3,75,25,1,104,3.23076923076923,0.506861066174239,61.404347826087
4287953710.jpg,2,23,74,8,0,107,2.82242990654206,0.579737808534454,51.53125
6635887941.jpg,0,2,71,34,0,107,3.29906542056075,0.499338303120032,62.0353982300885
5923067948.jpg,0,0,39,60,4,103,3.66019417475728,0.552239612285735,72.2629310344828
10745415703.jpg,0,3,51,45,4,103,3.48543689320388,0.624092716683751,69.1388888888889
8416061748.jpg,0,4,38,62,3,107,3.5981308411215,0.612138427495947,72.625
5416851305.jpg,2,36,66,8,0,112,2.71428571428571,0.6213697660012,46.825
7165207702.jpg,0,4,55,50,2,111,3.45045045045045,0.599071079994819,67.5945945945946
